S/T code,S/T name,LGA_code,LGA name,Males,Male_Percent,Females,Female_Percent,Overall,Overall_Percent
1,New South Wales,10050,Albury,17385,61.92121385,17868,60.69087327,35253,61.29144427
1,New South Wales,10180,Armidale,9227,64.18782609,9656,63.44700703,18883,63.80685274
1,New South Wales,10250,Ballina,13122,57.08443903,13806,56.83352544,26928,56.95551936
1,New South Wales,10300,Balranald,712,61.22098022,590,56.78537055,1302,59.1280654
1,New South Wales,10470,Bathurst,14363,63.44641753,13610,61.93683444,27973,62.70286022
1,New South Wales,10500,Bayside (NSW),66483,72.16999566,63822,70.2367196,130305,71.20997667
1,New South Wales,10550,Bega Valley,9733,53.99722607,10130,55.4946861,19863,54.75068221
1,New South Wales,10600,Bellingen,3540,54.73944642,3813,56.37196925,7353,55.57403069
1,New South Wales,10650,Berrigan,2219,51.0349586,2205,51.33876601,4424,51.18593081
1,New South Wales,10750,Blacktown,143578,67.22540348,140715,66.17989418,284293,66.7038165
1,New South Wales,10800,Bland,1627,58.88526963,1487,55.05368382,3114,56.99121523
1,New South Wales,10850,Blayney,2220,58.08477237,2278,59.60230246,4498,58.84353741
1,New South Wales,10900,Blue Mountains,23049,60.27773419,23888,59.41106248,46937,59.83351605
1,New South Wales,10950,Bogan,746,60.84828711,697,58.37520938,1443,59.62809917
1,New South Wales,11150,Bourke,703,60.2915952,770,64.22018349,1473,62.2832981
1,New South Wales,11200,Brewarrina,440,61.02635229,447,64.7826087,887,62.86321758
1,New South Wales,11250,Broken Hill,5221,60.3026103,5241,58.45416016,10462,59.36223332
1,New South Wales,11300,Burwood,15949,75.7384367,15656,73.02238806,31605,74.36820556
1,New South Wales,11350,Byron,11534,64.29925298,12679,66.07775693,24213,65.21844529
1,New South Wales,11400,Cabonne,3987,56.94087404,4111,59.77028206,8098,58.34293948
1,New South Wales,11450,Camden,43276,65.01802885,44542,65.26204744,87818,65.14156857
1,New South Wales,11500,Campbelltown (NSW),59163,64.80278651,60244,64.44104528,119407,64.61977227
1,New South Wales,11520,Canada Bay,30733,69.0799973,31535,67.24454111,62268,68.13809706
1,New South Wales,11570,Canterbury-Bankstown,127326,66.51239082,122798,65.18044343,250124,65.85173855
1,New South Wales,11600,Carrathool,989,66.64420485,763,59.56284153,1752,63.36347197
1,New South Wales,11650,Central Coast (NSW),103410,60.35368274,107122,59.31647785,210532,59.82144379
1,New South Wales,11700,Central Darling,494,55.13392857,561,65.15679443,1055,60.04553216
1,New South Wales,11720,Cessnock,21815,63.39542588,20797,62.67932489,42612,63.04389638
1,New South Wales,11730,Clarence Valley,15794,56.33873154,15222,55.78071751,31016,56.06348173
1,New South Wales,11750,Cobar,1274,61.33846895,1191,59.52023988,2465,60.4462972
1,New South Wales,11800,Coffs Harbour,23109,58.79554244,24163,58.66941848,47272,58.73100672
1,New South Wales,12000,Coolamon,1296,56.20121422,1263,56.30851538,2559,56.25412179
1,New South Wales,12150,Coonamble,1085,55.52712385,1137,59.62244363,2222,57.54985755
1,New South Wales,12160,Cootamundra-Gundagai,3111,53.88879266,3031,53.63652451,6142,53.7640056
1,New South Wales,12350,Cowra,3681,58.06909607,3537,55.96518987,7218,57.01872186
1,New South Wales,12380,Cumberland,89232,69.87353667,79379,67.48881974,168611,68.73020467
1,New South Wales,12390,Dubbo,17757,62.61062727,17153,60.8327127,34910,61.72424767
1,New South Wales,12700,Dungog,2918,58.94949495,2886,59.9128088,5804,59.42459302
1,New South Wales,12730,Edward River,2359,55.90047393,2479,58.88361045,4838,57.39027284
1,New South Wales,12750,Eurobodalla,10609,52.45228913,11035,53.34525766,21644,52.90379351
1,New South Wales,12850,Fairfield,68424,65.78724713,68898,65.16163202,137322,65.47186543
1,New South Wales,12870,Federation,3467,53.2728949,3501,54.43943399,6968,53.85269341
1,New South Wales,12900,Forbes,2638,56.93934815,2590,55.496036,5228,56.21505376
1,New South Wales,12930,Georges River,53662,68.48923434,53288,66.86072773,106950,67.66803121
1,New South Wales,12950,Gilgandra,1180,54.65493284,1198,55.72093023,2378,55.18681829
1,New South Wales,13010,Glen Innes Severn,2481,55.65275908,2475,54.62370338,4956,55.13405273
1,New South Wales,13310,Goulburn Mulwaree,10449,62.72285251,9644,60.0834839,20093,61.42769795
1,New South Wales,13340,Greater Hume,3320,56.73274094,3287,58.76989094,6607,57.72826562
1,New South Wales,13450,Griffith,8913,64.71357003,8431,63.1110113,17344,63.92451718
1,New South Wales,13550,Gunnedah,3887,58.25839329,3889,58.85290557,7776,58.55421687
1,New South Wales,13660,Gwydir,1297,52.83095723,1329,53.48088531,2626,53.15789474
1,New South Wales,13800,Hawkesbury,22093,64.69589153,21560,63.39871203,43653,64.04865309
1,New South Wales,13850,Hay,877,61.54385965,803,57.15302491,1680,59.3639576
1,New South Wales,13910,Hilltops,5337,55.95512686,5552,57.13697643,10889,56.55154505
1,New South Wales,14000,Hornsby,48246,63.617184,49132,62.80133957,97378,63.20291812
1,New South Wales,14100,Hunters Hill,4352,62.34063888,4172,59.13536499,8524,60.72955258
1,New South Wales,14170,Inner West,67759,73.27753085,69128,72.1165081,136887,72.68657905
1,New South Wales,14220,Inverell,5159,57.50752424,5185,57.05325704,10344,57.2789191
1,New South Wales,14300,Junee,2532,67.95491143,1640,58.6972083,4172,63.98773006
1,New South Wales,14350,Kempsey,9126,57.00187383,8660,56.07718708,17786,56.54786507
1,New South Wales,14400,Kiama,6233,55.3208485,6513,55.50063911,12746,55.41257282
1,New South Wales,14500,Ku-ring-gai,38364,62.3338641,40494,61.88242126,78858,62.10122615
1,New South Wales,14550,Kyogle,2559,54.09004439,2689,56.76588558,5248,55.42881284
1,New South Wales,14600,Lachlan,1747,56.37302356,1724,56.56167979,3471,56.46656906
1,New South Wales,14650,Lake Macquarie,65530,60.63662441,65974,59.34034305,131504,59.97929295
1,New South Wales,14700,Lane Cove,14014,68.66242038,14443,68.32395099,28457,68.49021637
1,New South Wales,14750,Leeton,3460,61.09835776,3436,59.57004161,6896,60.32718047
1,New South Wales,14850,Lismore,13427,61.60304643,13509,61.09628692,26936,61.34784886
1,New South Wales,14870,Lithgow,6275,59.74483481,5917,57.89061736,12192,58.83034163
1,New South Wales,14900,Liverpool,82503,66.67232351,82839,66.84445807,165342,66.75845473
1,New South Wales,14920,Liverpool Plains,2239,57.43971267,2207,58.55664633,4446,57.9887831
1,New South Wales,14950,Lockhart,918,53.81008206,962,56.92307692,1880,55.35924617
1,New South Wales,15050,Maitland,29736,63.09892628,30839,63.15455346,60575,63.12723407
1,New South Wales,15240,Mid-Coast,24761,51.38736121,25754,51.79390234,50515,51.59382692
1,New South Wales,15270,Mid-Western,7765,59.03147332,7516,58.87052557,15281,58.95220092
1,New South Wales,15300,Moree Plains,3999,61.45689258,4017,63.10084826,8016,62.26986716
1,New South Wales,15350,Mosman,8484,62.95636687,9746,62.49438923,18230,62.70854116
1,New South Wales,15520,Murray River,3535,52.99850075,3597,54.04146635,7132,53.51943569
1,New South Wales,15560,Murrumbidgee,1121,59.28080381,1062,61.88811189,2183,60.52120876
1,New South Wales,15650,Muswellbrook,5562,63.93838372,5125,63.43606882,10687,63.69650733
1,New South Wales,15700,Nambucca Valley,5369,52.6889107,5783,54.63907785,11152,53.68248773
1,New South Wales,15750,Narrabri,3910,59.57641323,3690,59.60264901,7600,59.5891485
1,New South Wales,15800,Narrandera,1562,54.80701754,1611,56.68543279,3173,55.74490513
1,New South Wales,15850,Narromine,1850,56.67892157,1814,57.06196917,3664,56.86791867
1,New South Wales,15900,Newcastle,59352,68.43149011,58519,66.83150225,117871,67.62768655
1,New South Wales,15950,North Sydney,24222,70.98229985,26916,71.03721298,51138,71.01119227
1,New South Wales,15990,Northern Beaches,85251,64.67228038,86882,63.8364156,172133,64.24767002
1,New South Wales,16100,Oberon,1740,59.26430518,1486,55.78078078,3226,57.60714286
1,New South Wales,16150,Orange,13129,60.61403509,13857,61.3575983,26986,60.99358105
1,New South Wales,16200,Parkes,4286,59.6354529,4105,58.07044844,8391,58.85942761
1,New South Wales,16260,Parramatta,96057,70.74771311,92509,69.36215519,188566,70.06111947
1,New South Wales,16350,Penrith,74042,66.21356966,73942,65.63287769,147984,65.9221411
1,New South Wales,16380,Port Macquarie-Hastings,23867,54.8099667,25387,55.12801025,49254,54.97343631
1,New South Wales,16400,Port Stephens,22094,57.2012945,22211,56.77223117,44305,56.98538869
1,New South Wales,16490,Queanbeyan-Palerang,22129,66.54337694,21373,66.55352806,43502,66.5483639
1,New South Wales,16550,Randwick,50088,71.77165129,50791,70.49214456,100879,71.12168641
1,New South Wales,16610,Richmond Valley,6662,56.48634899,6797,57.06489799,13459,56.77705126
1,New South Wales,16700,Ryde,47259,70.57901104,47678,69.34275783,94937,69.95269533
1,New South Wales,16900,Shellharbour,24362,62.02138493,25369,62.7045331,49731,62.36800522
1,New South Wales,16950,Shoalhaven,30945,56.34354175,30485,55.45449584,61430,55.8988125
1,New South Wales,17000,Singleton,8587,65.27556062,7742,63.57887821,16329,64.45997158
1,New South Wales,17040,Snowy Monaro,7298,63.67681703,6902,64.67997376,14200,64.1604916
1,New South Wales,17080,Snowy Valleys,4396,58.44190375,4244,57.25077566,8640,57.85068631
1,New South Wales,17100,Strathfield,18743,75.65898357,16748,72.65628389,35491,74.21169287
1,New South Wales,17150,Sutherland,73033,63.17678913,74759,62.59754831,147792,62.8824528
1,New South Wales,17200,Sydney,102579,84.37299511,90969,83.07064324,193548,83.75583116
1,New South Wales,17310,Tamworth,19362,59.92571959,19744,59.94656303,39106,59.9362413
1,New South Wales,17350,Temora,1633,54.96465836,1632,53.36821452,3265,54.1549179
1,New South Wales,17400,Tenterfield,1732,50.37812682,1883,53.26732673,3615,51.84282231
1,New South Wales,17420,The Hills,66570,64.59469425,68115,64.93265079,134685,64.76517006
1,New South Wales,17550,Tweed,27193,56.53665433,28660,56.34079695,55853,56.43598371
1,New South Wales,17620,Upper Hunter,4373,60.4422944,4276,60.19991553,8649,60.32222067
1,New South Wales,17640,Upper Lachlan,2485,55.63017685,2513,59.28284973,4998,57.40868367
1,New South Wales,17650,Uralla,1632,56.10175318,1909,60.8349267,3541,58.55796263
1,New South Wales,17750,Wagga Wagga,21244,62.91535864,21848,62.51216023,43092,62.71028581
1,New South Wales,17850,Walcha,801,53.57859532,775,52.61371351,1576,53.09973046
1,New South Wales,17900,Walgett,1540,55.95930233,1637,59.1615468,3177,57.56477623
1,New South Wales,17950,Warren,732,55.7501904,696,54.80314961,1428,55.28455285
1,New South Wales,18020,Warrumbungle,2558,54.78689227,2474,54.26628647,5032,54.52969224
1,New South Wales,18050,Waverley,25622,73.2601361,26588,72.96377607,52210,73.10891422
1,New South Wales,18100,Weddin,1003,54.33369447,951,53.72881356,1954,54.03761062
1,New South Wales,18200,Wentworth,2386,58.94268775,2113,58.04945055,4499,58.51977107
1,New South Wales,18250,Willoughby,25290,67.08044879,26762,66.61688199,52052,66.84130775
1,New South Wales,18350,Wingecarribee,14493,56.11352021,14920,54.69007734,29413,55.38232691
1,New South Wales,18400,Wollondilly,18224,62.8457135,18045,63.05472081,36269,62.94952791
1,New South Wales,18450,Wollongong,70931,65.04745747,70048,63.62447319,140979,64.33255301
1,New South Wales,18500,Woollahra,16705,65.37904583,19093,65.59139785,35798,65.49213319
1,New South Wales,18710,Yass Valley,5394,62.07134638,5480,62.36485718,10874,62.21891629
1,New South Wales,19399,Unincorporated NSW,284,57.25806452,338,65.37717602,622,61.4017769
2,Victoria,20110,Alpine,3860,58.60027327,3864,58.58984079,7724,58.59505386
2,Victoria,20260,Ararat,3781,61.3002594,3205,58.11423391,6986,59.7962852
2,Victoria,20570,Ballarat,36084,63.09053397,37972,62.307402,74056,62.6865419
2,Victoria,20660,Banyule,40908,64.66032308,41811,63.02912446,82719,63.82540393
2,Victoria,20740,Bass Coast,11356,54.36614324,12097,55.38665812,23453,54.88778113
2,Victoria,20830,Baw Baw,17436,59.00507614,18613,59.86042323,36049,59.44363828
2,Victoria,20910,Bayside (Vic.),31178,62.47345009,33539,61.69113049,64717,62.06555931
2,Victoria,21010,Benalla,3962,55.81854043,4167,56.07589826,8129,55.95016863
2,Victoria,21110,Boroondara,56522,67.44224895,60240,66.39552954,116762,66.89813621
2,Victoria,21180,Brimbank,66297,67.2437926,64132,65.80745788,130429,66.52979403
2,Victoria,21270,Buloke,1759,56.39628086,1619,55.4262239,3378,55.92715232
2,Victoria,21370,Campaspe,10910,57.70044426,11235,57.93925017,22145,57.82135304
2,Victoria,21450,Cardinia,40949,65.034543,41444,64.76130948,82393,64.8968179
2,Victoria,21610,Casey,131863,67.04614211,129795,66.41338552,261658,66.73076433
2,Victoria,21670,Central Goldfields,3688,54.4193596,3732,54.90657643,7420,54.66332695
2,Victoria,21750,Colac Otway,6580,58.79724779,6447,58.1754196,13027,58.48785525
2,Victoria,21830,Corangamite,4726,58.62796179,4579,58.05756308,9305,58.34587409
2,Victoria,21890,Darebin,54827,72.18543046,56524,70.89426816,111351,71.52418697
2,Victoria,22110,East Gippsland,12797,52.83868037,13533,54.21875,26330,53.53911222
2,Victoria,22170,Frankston,46019,65.50374356,46669,64.30717081,92688,64.89574727
2,Victoria,22250,Gannawarra,2771,53.37057011,2796,53.48125478,5567,53.42610365
2,Victoria,22310,Glen Eira,51880,68.07148293,53850,66.79235454,105730,67.41393931
2,Victoria,22410,Glenelg,5794,57.98638911,5767,57.49750748,11561,57.74148437
2,Victoria,22490,Golden Plains,8266,61.87588891,7884,63.27955695,16150,62.55325742
2,Victoria,22620,Greater Bendigo,37030,61.25622405,39252,61.59785321,76282,61.43153961
2,Victoria,22670,Greater Dandenong,57077,68.52803458,53215,66.10394773,110292,67.33662206
2,Victoria,22750,Greater Geelong,87601,63.38941351,89782,62.08389229,177383,62.721837
2,Victoria,22830,Greater Shepparton,21248,61.61876867,21166,61.08161145,42414,61.34953352
2,Victoria,22910,Hepburn,4717,57.58759614,4864,57.36525534,9581,57.4745051
2,Victoria,22980,Hindmarsh,1601,57.05630791,1539,55.90265165,3140,56.48497931
2,Victoria,23110,Hobsons Bay,30257,65.87489931,31152,65.16200556,61409,65.51131878
2,Victoria,23190,Horsham,6040,60.19533586,6166,59.97471063,12206,60.08368201
2,Victoria,23270,Hume,88364,67.00028813,86873,66.377084,175237,66.68988141
2,Victoria,23350,Indigo,5005,57.727797,5335,59.33051601,10340,58.54376628
2,Victoria,23430,Kingston (Vic.),52336,65.56752694,53520,63.78718535,105856,64.65515135
2,Victoria,23670,Knox,52140,65.51321196,53037,64.53838572,105177,65.01798895
2,Victoria,23810,Latrobe (Vic.),23313,60.80118927,24264,60.9479792,47577,60.87596284
2,Victoria,23940,Loddon,2162,54.32160804,2082,55.26944518,4244,54.78249645
2,Victoria,24130,Macedon Ranges,15711,60.18387282,16249,60.59668096,31960,60.39304611
2,Victoria,24210,Manningham,39539,62.89209137,40811,61.235483,80350,62.03962506
2,Victoria,24250,Mansfield,2846,55.40198559,3138,58.01442041,5984,56.74189266
2,Victoria,24330,Maribyrnong,34932,75.20506362,33567,74.07807914,68499,74.64854733
2,Victoria,24410,Maroondah,37115,65.06723234,38489,63.73089596,75604,64.37999217
2,Victoria,24600,Melbourne,78411,88.36237012,77741,87.6863904,156152,88.02453268
2,Victoria,24650,Melton,69337,67.16098411,68539,66.6527278,137876,66.90736158
2,Victoria,24700,Merri-bek,65547,73.74194202,66157,71.64811125,131704,72.67510195
2,Victoria,24780,Mildura,17771,62.33688789,17876,61.54375818,35647,61.93661605
2,Victoria,24850,Mitchell,17414,63.97266816,16851,63.58388046,34265,63.78087597
2,Victoria,24900,Moira,8604,55.68211235,8534,55.69405469,17138,55.68805849
2,Victoria,24970,Monash,70966,69.43360044,67650,66.74691425,138616,68.0958931
2,Victoria,25060,Moonee Valley,42054,68.32826945,43287,66.65794053,85341,67.47070822
2,Victoria,25150,Moorabool,12254,63.07066756,12388,63.00157657,24642,63.03591528
2,Victoria,25340,Mornington Peninsula,46793,56.74148447,49044,55.87404302,95837,56.29423824
2,Victoria,25430,Mount Alexander,5964,57.77390294,5676,55.359407,11640,56.57076205
2,Victoria,25490,Moyne,5082,58.29318651,5294,59.53666217,10376,58.92106758
2,Victoria,25620,Murrindindi,4704,58.06690532,4397,59.57187373,9101,58.78439478
2,Victoria,25710,Nillumbik,20061,63.97206544,20504,64.26578906,40565,64.12019474
2,Victoria,25810,Northern Grampians,3496,58.14069516,3402,57.99522673,6898,58.06886102
2,Victoria,25900,Port Phillip,40837,76.03805906,42500,76.15259188,83337,76.09642515
2,Victoria,25990,Pyrenees,2355,57.81978885,2135,57.50067331,4490,57.66760853
2,Victoria,26080,Queenscliffe,658,42.97844546,718,42.06209725,1376,42.49536751
2,Victoria,26170,South Gippsland,8516,55.4535391,8822,57.04125178,17338,56.25020277
2,Victoria,26260,Southern Grampians,4657,57.55778025,4728,56.42678124,9385,56.98239223
2,Victoria,26350,Stonnington,39348,73.71576305,41986,72.44336318,81334,73.0533974
2,Victoria,26430,Strathbogie,3097,53.67417678,3179,54.73484848,6276,54.20625324
2,Victoria,26490,Surf Coast,11695,59.8056763,11985,60.72351421,23680,60.26672096
2,Victoria,26610,Swan Hill,6707,62.5944937,6352,60.51252739,13059,61.56420894
2,Victoria,26670,Towong,1727,54.0701315,1701,55.78878321,3428,54.90949864
2,Victoria,26700,Wangaratta,8424,57.96064401,9008,58.23635893,17432,58.10279315
2,Victoria,26730,Warrnambool,10768,61.7714548,11296,61.1420839,22064,61.4476286
2,Victoria,26810,Wellington,13949,59.68763372,13390,58.84679617,27339,59.27282976
2,Victoria,26890,West Wimmera,1117,55.79420579,1037,53.70274469,2154,54.76735317
2,Victoria,26980,Whitehorse,59572,68.22184812,60104,65.81834907,119676,66.99320977
2,Victoria,27070,Whittlesea,81598,66.71408716,81100,66.08593616,162698,66.39948741
2,Victoria,27170,Wodonga,13607,62.88764616,13917,61.47356332,27524,62.16460385
2,Victoria,27260,Wyndham,111102,67.47645047,106317,66.68401972,217419,67.08661563
2,Victoria,27350,Yarra,38076,79.42759398,38540,77.84286003,76616,78.62244479
2,Victoria,27450,Yarra Ranges,49741,63.2418756,50580,63.19182429,100321,63.21663075
2,Victoria,27630,Yarriambiack,1778,54.47303922,1734,55.488,3512,54.96947879
2,Victoria,29399,Unincorporated Vic,400,80.64516129,360,78.77461707,760,79.74816369
3,Queensland,30250,Aurukun,379,71.50943396,430,68.91025641,809,70.10398614
3,Queensland,30300,Balonne,1390,62.75395034,1334,62.62910798,2724,62.69275029
3,Queensland,30370,Banana,4762,61.94068678,4540,62.78523026,9302,62.35002346
3,Queensland,30410,Barcaldine,873,60.37344398,901,62.22375691,1774,61.29923981
3,Queensland,30450,Barcoo,107,66.875,119,75.79617834,226,71.29337539
3,Queensland,30760,Blackall Tambo,542,54.8582996,535,55.44041451,1077,55.14592934
3,Queensland,30900,Boulia,148,64.34782609,145,58.46774194,293,61.29707113
3,Queensland,31000,Brisbane,463369,70.56430858,462515,69.39459865,925884,69.97510509
3,Queensland,31750,Bulloo,134,69.07216495,87,57.23684211,221,63.87283237
3,Queensland,31820,Bundaberg,29318,57.15009747,30655,57.98622933,59973,57.57444848
3,Queensland,31900,Burdekin,5178,59.51724138,4892,58.79807692,10070,59.16568743
3,Queensland,31950,Burke,190,73.07692308,121,67.97752809,311,71.00456621
3,Queensland,32080,Cairns,56530,65.09373129,58474,66.03202566,115004,65.56745231
3,Queensland,32250,Carpentaria,751,64.51890034,699,66.69847328,1450,65.55153707
3,Queensland,32260,Cassowary Coast,8906,58.03088552,8721,59.63076923,17627,58.81155745
3,Queensland,32270,Central Highlands (Qld),10174,67.22611339,9115,65.86458559,19289,66.57577745
3,Queensland,32310,Charters Towers,3447,57.26864928,3632,60.59392726,7079,58.92782819
3,Queensland,32330,Cherbourg,333,52.68987342,392,62.02531646,725,57.35759494
3,Queensland,32450,Cloncurry,1564,71.155596,1122,67.87658802,2686,69.74811737
3,Queensland,32500,Cook,1590,62.82101936,1465,65.69506726,3055,64.16719177
3,Queensland,32600,Croydon,86,62.77372263,97,72.93233083,183,67.77777778
3,Queensland,32750,Diamantina,118,73.75,84,75,202,74.26470588
3,Queensland,32770,Doomadgee,469,62.61682243,456,64.04494382,925,63.31279945
3,Queensland,32810,Douglas,4130,63.29501916,4123,65.41329526,8253,64.33582788
3,Queensland,33100,Etheridge,225,59.84042553,207,59.14285714,432,59.50413223
3,Queensland,33200,Flinders (Qld),435,57.31225296,488,62.1656051,923,59.77979275
3,Queensland,33220,Fraser Coast,31463,54.42013318,33190,55.2016632,64653,54.81855181
3,Queensland,33360,Gladstone,21499,63.49192286,21360,64.77831018,42859,64.12658038
3,Queensland,33430,Gold Coast,212678,65.37320682,222486,65.29149719,435164,65.33140566
3,Queensland,33610,Goondiwindi,3035,57.88670608,3103,59.56997504,6138,58.72560276
3,Queensland,33620,Gympie,15806,56.76626921,16629,58.71407386,32435,57.74845992
3,Queensland,33800,Hinchinbrook,3168,56.01131542,3033,55.52911022,6201,55.77441986
3,Queensland,33830,Hope Vale,323,60.94339623,326,65.72580645,649,63.25536062
3,Queensland,33960,Ipswich,81774,65.37317728,83058,65.88767254,164832,65.63142052
3,Queensland,33980,Isaac,9405,72.50231267,7079,70.42379626,16484,71.59485754
3,Queensland,34420,Kowanyama,371,64.86013986,406,70.60869565,777,67.74193548
3,Queensland,34530,Livingstone,13061,60.65010448,12438,61.0573855,25499,60.84808858
3,Queensland,34570,Lockhart River,206,58.1920904,213,66.77115987,419,62.25854383
3,Queensland,34580,Lockyer Valley,13687,62.62067072,14347,65.24329241,28034,63.93595913
3,Queensland,34590,Logan,121314,64.73705275,122847,64.52793915,244161,64.63167034
3,Queensland,34710,Longreach,1125,60.74514039,1235,65.51724138,2360,63.15226117
3,Queensland,34770,Mackay,41247,64.45750184,40502,64.37472185,81749,64.41646245
3,Queensland,34800,McKinlay,320,69.86899563,264,67.51918159,584,68.78680801
3,Queensland,34830,Mapoon,138,62.16216216,142,58.43621399,280,60.21505376
3,Queensland,34860,Maranoa,4115,61.74043511,4172,63.30804249,8287,62.51980385
3,Queensland,34880,Mareeba,7901,63.11206965,6859,61.33416793,14760,62.27322589
3,Queensland,35010,Moreton Bay,157855,62.92879723,163094,62.90823391,320949,62.91834606
3,Queensland,35250,Mornington,346,68.24457594,395,69.05594406,741,68.6746988
3,Queensland,35300,Mount Isa,6573,67.27737973,6357,69.28610354,12930,68.25019794
3,Queensland,35600,Murweh,1144,60.24223275,1301,62.94146105,2445,61.64901664
3,Queensland,35670,Napranum,308,67.10239651,300,64.51612903,608,65.8008658
3,Queensland,35740,Noosa,16080,56.66560947,17433,58.12937646,33513,57.41771892
3,Queensland,35760,North Burnett,3036,57.20746184,2942,58.31516353,5978,57.74729521
3,Queensland,35780,Northern Peninsula Area,856,59.1568763,915,62.62833676,1771,60.90096286
3,Queensland,35790,Palm Island,697,64.89757914,697,61.14035088,1394,62.96296296
3,Queensland,35800,Paroo,529,59.3714927,492,58.99280576,1021,59.1884058
3,Queensland,36070,Pormpuraaw,222,68.51851852,230,71.875,452,70.1863354
3,Queensland,36150,Quilpie,188,55.45722714,220,59.45945946,408,57.54583921
3,Queensland,36250,Redland,50281,61.34672165,51577,60.78824237,101858,61.06265249
3,Queensland,36300,Richmond,259,64.10891089,237,62.86472149,496,63.50832266
3,Queensland,36370,Rockhampton,26345,63.19867581,26892,62.78629964,53237,62.98969438
3,Queensland,36510,Scenic Rim,13316,59.03790734,13665,60.21680694,26981,59.62915488
3,Queensland,36580,Somerset,7928,59.22163293,7823,60.81312189,15751,60.00152375
3,Queensland,36630,South Burnett,9607,56.02402613,9838,57.39120289,19445,56.7074949
3,Queensland,36660,Southern Downs,10334,55.94413166,10739,56.60446974,21073,56.27870954
3,Queensland,36720,Sunshine Coast,107506,60.82066543,115985,61.3083628,223491,61.07279296
3,Queensland,36820,Tablelands,7456,55.43494424,7900,57.20906655,15356,56.33368796
3,Queensland,36910,Toowoomba,54065,61.15881042,56708,60.7022051,110773,60.92420567
3,Queensland,36950,Torres,1093,62.92458261,1158,65.60906516,2251,64.27755568
3,Queensland,36960,Torres Strait Island,1287,60.33755274,1304,60.56665118,2591,60.45263649
3,Queensland,37010,Townsville,67467,66.69929116,66565,66.37781456,134032,66.5392463
3,Queensland,37300,Weipa,1593,70.7057257,1424,71.27127127,3017,70.97153611
3,Queensland,37310,Western Downs,10855,60.93521949,10510,61.18647028,21365,61.05855791
3,Queensland,37340,Whitsunday,13463,65.73730469,12847,66.80012479,26310,66.2520145
3,Queensland,37400,Winton,323,59.04936015,356,60.23688663,679,59.66608084
3,Queensland,37550,Woorabinda,270,53.57142857,346,59.96533795,616,56.98427382
3,Queensland,37570,Wujal Wujal,88,65.18518519,92,58.2278481,180,61.4334471
3,Queensland,37600,Yarrabah,817,63.92801252,875,64.24375918,1692,64.09090909
4,South Australia,40070,Adelaide,11714,81.596545,10585,78.14691768,22299,79.9218666
4,South Australia,40120,Adelaide Hills,12661,61.4373059,13165,61.99962325,25826,61.722671
4,South Australia,40150,Adelaide Plains,3769,66.4258019,3519,66.92658806,7288,66.66666667
4,South Australia,40220,Alexandrina,7823,51.96625482,8160,53.44161373,15983,52.70916466
4,South Australia,40250,Anangu Pitjantjatjara Yankunytjatjara,905,73.10177706,1007,72.23816356,1912,72.6443769
4,South Australia,40310,Barossa,7860,60.0045805,7844,59.56412788,15704,59.78376732
4,South Australia,40430,Barunga West,721,51.02618542,646,50.98658248,1367,51.00746269
4,South Australia,40520,Berri Barmera,3381,61.25,3086,59.23224568,6467,60.27027027
4,South Australia,40700,Burnside,13898,61.09548092,14688,59.47521866,28586,60.25208667
4,South Australia,40910,Campbelltown (SA),18188,65.54470431,18484,62.84723403,36672,64.15675297
4,South Australia,41010,Ceduna,1169,61.07628004,1041,57.73710483,2210,59.45655098
4,South Australia,41060,Charles Sturt,41299,66.4473155,42027,64.37269288,83326,65.38449466
4,South Australia,41140,Clare and Gilbert Valleys,2659,56.86484175,2739,57.91922182,5398,57.39500266
4,South Australia,41190,Cleve,544,58.36909871,444,53.81818182,988,56.232214
4,South Australia,41330,Coober Pedy,497,54.91712707,411,63.72093023,908,58.58064516
4,South Australia,41560,Copper Coast,4251,52.59185946,4120,52.3640061,8371,52.47946837
4,South Australia,41750,Elliston,324,59.01639344,297,60.36585366,621,59.65417867
4,South Australia,41830,Flinders Ranges,466,53.74855825,435,53.97022333,901,53.85534967
4,South Australia,41960,Franklin Harbour,365,52.74566474,340,53.125,705,52.92792793
4,South Australia,42030,Gawler,7956,61.18117502,8335,60.46427276,16291,60.81227369
4,South Australia,42110,Goyder,1177,55.20637899,1123,56.15,2300,55.66311713
4,South Australia,42250,Grant,3339,65.75423395,2444,61.62380232,5783,63.9429456
4,South Australia,42600,Holdfast Bay,11242,60.7938568,11969,59.03620401,23211,59.87463241
4,South Australia,42750,Kangaroo Island,1478,55.04655493,1351,55.36885246,2829,55.2
4,South Australia,43080,Karoonda East Murray,313,55.20282187,249,55.45657016,562,55.31496063
4,South Australia,43220,Kimba,313,56.60036166,289,57.11462451,602,56.84608121
4,South Australia,43360,Kingston (SA),664,54.65020576,666,56.53650255,1330,55.57877142
4,South Australia,43650,Light,5358,63.56625934,5357,65.43300354,10715,64.48603755
4,South Australia,43710,Lower Eyre Peninsula,1934,59.14373089,1776,61.58113731,3710,60.28599285
4,South Australia,43790,Loxton Waikerie,3414,56.15131579,3300,56.73027334,6714,56.43439523
4,South Australia,44000,Maralinga Tjarutja,43,72.88135593,33,76.74418605,76,74.50980392
4,South Australia,44060,Marion,31213,65.86688613,32887,64.35182467,64100,65.08076716
4,South Australia,44210,Mid Murray,2851,55.90196078,2447,55.66424022,5298,55.79191238
4,South Australia,44340,Mitcham,21104,62.7087419,22153,61.72815426,43257,62.20269765
4,South Australia,44550,Mount Barker,12808,62.50854075,13798,63.27326088,26606,62.90280635
4,South Australia,44620,Mount Gambier,8299,60.67407516,8565,60.45313382,16864,60.56166056
4,South Australia,44830,Mount Remarkable,775,52.75697754,787,55.11204482,1562,53.91784605
4,South Australia,45040,Murray Bridge,7246,61.89459298,6682,59.69269251,13928,60.81830488
4,South Australia,45090,Naracoorte Lucindale,2957,62.62177044,2499,59.41512126,5456,61.11111111
4,South Australia,45120,Northern Areas,1318,54.71149855,1214,53.76439327,2532,54.25326762
4,South Australia,45290,Norwood Payneham and St Peters,12877,67.44003352,12874,63.67593234,25751,65.50417175
4,South Australia,45340,Onkaparinga,55199,62.49391466,57285,61.90429877,112484,62.19224283
4,South Australia,45400,Orroroo Carrieton,243,55.10204082,236,52.67857143,479,53.8807649
4,South Australia,45540,Peterborough,480,54.98281787,436,53.82716049,916,54.42661913
4,South Australia,45680,Playford,34372,64.98279578,34905,64.43008768,69277,64.70313536
4,South Australia,45890,Port Adelaide Enfield,47580,69.05459929,46466,66.68197408,94046,67.86160118
4,South Australia,46090,Port Augusta,4953,65.13677012,4315,63.30692488,9268,64.27184466
4,South Australia,46300,Port Lincoln,4564,60.64310391,4541,60.61131874,9105,60.6272473
4,South Australia,46450,Port Pirie,5337,60.42114797,5142,58.63838522,10479,59.53300761
4,South Australia,46510,Prospect,7961,68.74190484,7792,67.42817584,15753,68.0857501
4,South Australia,46670,Renmark Paringa,3220,61.63859112,2900,59.38971943,6120,60.55209261
4,South Australia,46860,Robe,472,59,440,54.79452055,912,56.89332502
4,South Australia,46970,Roxby Downs,1718,75.64949362,1272,69.05537459,2990,72.69632871
4,South Australia,47140,Salisbury,49705,66.45408845,47762,64.18070897,97467,65.32027826
4,South Australia,47290,Southern Mallee,647,62.09213052,556,57.31958763,1203,59.79125249
4,South Australia,47490,Streaky Bay,611,53.22299652,625,55.30973451,1236,54.25812116
4,South Australia,47630,Tatiara,2346,63.94112837,2059,60.61230497,4405,62.34078687
4,South Australia,47700,Tea Tree Gully,32231,63.36826377,32430,61.39487335,64661,62.36292617
4,South Australia,47800,Coorong,1705,56.40092623,1438,55.54268057,3143,56.00498931
4,South Australia,47910,Tumby Bay,759,52.34482759,735,50.48076923,1494,51.41087405
4,South Australia,47980,Unley,12039,63.65462909,13106,62.3620099,25145,62.97427935
4,South Australia,48050,Victor Harbor,3677,45.66567312,3964,44.9586027,7641,45.29610528
4,South Australia,48130,Wakefield,2094,58.26377295,1958,58.20451843,4052,58.23512504
4,South Australia,48260,Walkerville,2465,62.595226,2707,60.39714413,5172,61.42517815
4,South Australia,48340,Wattle Range,3700,58.42412759,3470,58.57528697,7170,58.49718528
4,South Australia,48410,West Torrens,21894,69.46727163,22112,67.00199988,44006,68.20626482
4,South Australia,48540,Whyalla,7188,64.04133999,6635,62.13710433,13823,63.11295772
4,South Australia,48640,Wudinna,341,58.89464594,347,59.62199313,688,59.25925926
4,South Australia,48750,Yankalilla,1549,50.29220779,1617,53.54304636,3166,51.90163934
4,South Australia,48830,Yorke Peninsula,3097,49.49656385,2897,50.09510635,5994,49.78405316
4,South Australia,49399,Unincorporated SA,1263,72.5862069,877,68.78431373,2140,70.97844113
5,Western Australia,50080,Albany,12020,59.45785516,12241,59.04114214,24261,59.24686806
5,Western Australia,50210,Armadale,34021,64.91566173,34155,64.8274684,68176,64.87144842
5,Western Australia,50250,Ashburton,3518,74.32917811,2317,69.30900389,5835,72.25111441
5,Western Australia,50280,Augusta Margaret River,5746,61.45454545,5786,62.41639698,11532,61.93340494
5,Western Australia,50350,Bassendean,5550,66.03212374,5470,64.28487484,11020,65.15312759
5,Western Australia,50420,Bayswater,25563,68.66421338,24613,66.4246775,50176,67.54708345
5,Western Australia,50490,Belmont,16907,71.75841433,15458,68.96274816,32365,70.3954237
5,Western Australia,50560,Beverley,447,49.83277592,492,56.48679679,939,53.11085973
5,Western Australia,50630,Boddington,542,58.34230355,520,60.67677946,1062,59.462486
5,Western Australia,50770,Boyup Brook,539,54.49949444,566,59.0198123,1105,56.724846
5,Western Australia,50840,Bridgetown-Greenbushes,1536,54.08450704,1655,58.50123719,3191,56.28858705
5,Western Australia,50910,Brookton,284,57.25806452,261,56.8627451,545,57.06806283
5,Western Australia,50980,Broome,6132,67.49587232,6783,71.20512282,12915,69.39444415
5,Western Australia,51080,Broomehill-Tambellup,349,61.98934281,335,62.96992481,684,62.46575342
5,Western Australia,51120,Bruce Rock,320,59.59031657,270,53.35968379,590,56.56759348
5,Western Australia,51190,Bunbury,10851,62.69355211,10824,61.99312715,21675,62.34180856
5,Western Australia,51260,Busselton,12424,57.81024615,13018,57.9144052,25442,57.86349473
5,Western Australia,51310,Cambridge,9765,63.71941272,10021,63.39195344,19786,63.55314297
5,Western Australia,51330,Canning,36325,69.05762248,34135,66.81346643,70460,67.95189554
5,Western Australia,51400,Capel,5971,62.7469525,6382,64.99643548,12353,63.88931989
5,Western Australia,51470,Carnamah,169,54.87012987,177,65.31365314,346,59.7582038
5,Western Australia,51540,Carnarvon,1787,62.09173037,1734,65.43396226,3521,63.69392185
5,Western Australia,51610,Chapman Valley,532,61.71693735,509,63.54556804,1041,62.59771497
5,Western Australia,51680,Chittering,2139,64.52488688,2023,63.19900031,4162,63.87354205
9,Other Territories,51710,Christmas Island,764,71.20223672,535,71.33333333,1299,71.25617115
5,Western Australia,51750,Claremont,3660,61.92893401,3792,60.49776643,7452,61.19231401
5,Western Australia,51820,Cockburn,43965,67.8419875,44045,67.2678956,88010,67.55346095
9,Other Territories,51860,Cocos Islands,173,52.90519878,198,65.13157895,371,58.7955626
5,Western Australia,51890,Collie,2706,57.4278438,2819,61.50992799,5525,59.44055944
5,Western Australia,51960,Coolgardie,1380,68.65671642,1137,67.84009547,2517,68.28540423
5,Western Australia,52030,Coorow,290,48.49498328,298,58.54616896,588,53.11653117
5,Western Australia,52100,Corrigin,307,56.95732839,259,52.85714286,566,55.00485909
5,Western Australia,52170,Cottesloe,2674,61.91247974,2759,63.04844607,5433,62.48418631
5,Western Australia,52240,Cranbrook,348,56.76998369,294,54.85074627,642,55.87467363
5,Western Australia,52310,Cuballing,283,54.63320463,279,64.43418014,562,59.09568875
5,Western Australia,52380,Cue,98,65.33333333,39,48.14814815,137,59.30735931
5,Western Australia,52450,Cunderdin,411,59.65166909,392,61.92733017,803,60.74130106
5,Western Australia,52520,Dalwallinu,462,63.28767123,410,57.26256983,872,60.30428769
5,Western Australia,52590,Dandaragan,1135,56.18811881,1022,59.14351852,2157,57.5506937
5,Western Australia,52660,Dardanup,4790,61.45753143,4812,60.98086428,9602,61.21772394
5,Western Australia,52730,Denmark,1733,53.35591133,1907,56.58753709,3640,55.00151103
5,Western Australia,52800,Derby-West Kimberley,2942,68.48230912,2902,70.14744984,5844,69.29918179
5,Western Australia,52870,Donnybrook-Balingup,1804,56.78312874,1875,57.49770009,3679,57.14507611
5,Western Australia,52940,Dowerin,208,54.16666667,200,56.49717514,408,55.28455285
5,Western Australia,53010,Dumbleyung,209,57.89473684,213,62.64705882,422,60.19971469
5,Western Australia,53080,Dundas,219,59.83606557,233,69.55223881,452,64.47931526
5,Western Australia,53150,East Fremantle,2489,63.57598978,2721,63.17622475,5210,63.36657748
5,Western Australia,53220,East Pilbara,5744,84.68229397,2739,75.70480929,8483,81.55946544
5,Western Australia,53290,Esperance,4560,61.48867314,4302,60.32814472,8862,60.91977727
5,Western Australia,53360,Exmouth,1255,69.33701657,1177,71.07487923,2432,70.16733987
5,Western Australia,53430,Fremantle,11436,65.83386103,11552,64.94996064,22988,65.38669397
5,Western Australia,53570,Gingin,1848,58.18639798,1768,61.21883657,3616,59.63060686
5,Western Australia,53640,Gnowangerup,419,60.81277213,374,64.48275862,793,62.49014972
5,Western Australia,53710,Goomalling,287,57.28542914,270,55.55555556,557,56.43363728
5,Western Australia,53780,Gosnells,46666,66.97956137,44278,65.41967702,90944,66.21091333
5,Western Australia,53800,Greater Geraldton,12958,62.42713302,13052,61.69116604,26010,62.05563773
5,Western Australia,53920,Halls Creek,1393,67.1972986,1443,69.94667959,2836,68.56866538
5,Western Australia,53990,Harvey,9388,61.1118344,9455,61.28467721,18843,61.19844105
5,Western Australia,54060,Irwin,1031,54.09233998,1064,54.95867769,2095,54.5288912
5,Western Australia,54130,Jerramungup,388,60.15503876,352,61.97183099,740,61.00577082
5,Western Australia,54170,Joondalup,53794,63.46176533,53239,62.71453982,107033,63.08787731
5,Western Australia,54200,Kalamunda,19617,62.71218951,19354,61.6585428,38971,62.18445827
5,Western Australia,54280,Kalgoorlie-Boulder,11349,69.26879883,9848,68.43165868,21197,68.8773355
5,Western Australia,54310,Karratha,9699,72.98517571,7686,70.20460358,17385,71.7291744
5,Western Australia,54340,Katanning,1424,64.2599278,1250,60.27000964,2674,62.33100233
5,Western Australia,54410,Kellerberrin,365,60.13179572,324,57.96064401,689,59.09090909
5,Western Australia,54480,Kent,186,62.83783784,149,65.35087719,335,63.93129771
5,Western Australia,54550,Kojonup,541,55.83075335,562,56.31262525,1103,56.07524148
5,Western Australia,54620,Kondinin,271,58.91304348,245,61.55778894,516,60.13986014
5,Western Australia,54690,Koorda,126,61.76470588,91,54.49101796,217,58.49056604
5,Western Australia,54760,Kulin,216,55.52699229,225,55.55555556,441,55.54156171
5,Western Australia,54830,Kwinana,18796,69.55813781,17005,67.80032694,35801,68.71197436
5,Western Australia,54900,Lake Grace,450,62.84916201,374,63.93162393,824,63.33589547
5,Western Australia,54970,Laverton,849,84.56175299,351,80.68965517,1200,83.39124392
5,Western Australia,55040,Leonora,871,80.8727948,467,71.29770992,1338,77.2517321
5,Western Australia,55110,Mandurah,27575,57.48743928,29420,57.34333886,56995,57.4129664
5,Western Australia,55180,Manjimup,2848,60.18596788,2856,60.68848279,5704,60.43653316
5,Western Australia,55250,Meekatharra,632,79,352,71.25506073,984,76.04327666
5,Western Australia,55320,Melville,33539,62.5074549,35121,61.86542188,68660,62.17738576
5,Western Australia,55390,Menzies,368,88.24940048,113,71.51898734,481,83.65217391
5,Western Australia,55460,Merredin,1011,60.502693,972,60.86412023,1983,60.67931457
5,Western Australia,55530,Mingenew,129,56.08695652,93,49.73262032,222,53.23741007
5,Western Australia,55600,Moora,751,61.30612245,707,60.58269066,1458,60.95317726
5,Western Australia,55670,Morawa,206,56.74931129,178,56.32911392,384,56.55375552
5,Western Australia,55740,Mosman Park,3155,65.51079734,3357,64.35966258,6512,64.9122807
5,Western Australia,55810,Mount Magnet,240,63.66047745,218,67.28395062,458,65.33523538
5,Western Australia,55880,Mount Marshall,162,66.12244898,131,60.64814815,293,63.55748373
5,Western Australia,55950,Mukinbudin,195,58.38323353,152,57.14285714,347,57.83333333
5,Western Australia,56090,Mundaring,14022,64.61453389,12152,61.62271805,26174,63.19016924
5,Western Australia,56160,Murchison,40,70.1754386,33,67.34693878,73,68.86792453
5,Western Australia,56230,Murray,5632,56.98674492,5807,58.42052314,11439,57.7056954
5,Western Australia,56300,Nannup,455,53.97390273,440,55.76679341,895,54.84068627
5,Western Australia,56370,Narembeen,258,56.82819383,214,56.46437995,472,56.66266507
5,Western Australia,56460,Narrogin,1500,60.26516673,1547,62.02886929,3047,61.14790287
5,Western Australia,56580,Nedlands,7491,62.10412867,7445,61.70741815,14936,61.90574875
5,Western Australia,56620,Ngaanyatjarraku,517,75.03628447,587,74.30379747,1104,74.64503043
5,Western Australia,56730,Northam,3804,61.36473625,3631,60.57724391,7435,60.9776101
5,Western Australia,56790,Northampton,937,52.2005571,862,54.76493011,1799,53.39863461
5,Western Australia,56860,Nungarin,73,54.47761194,75,61.47540984,148,57.8125
5,Western Australia,56930,Peppermint Grove,489,63.671875,626,64.66942149,1115,64.2281106
5,Western Australia,57000,Perenjori,293,73.43358396,154,61.6,447,68.8751926
5,Western Australia,57080,Perth,14768,83.91385874,12579,82.44740119,27347,83.23289506
5,Western Australia,57140,Pingelly,290,53.11355311,305,56.69144981,595,54.88929889
5,Western Australia,57210,Plantagenet,1691,58.29024474,1663,60.07947977,3354,59.1638737
5,Western Australia,57280,Port Hedland,6675,72.91097761,5699,70.4275828,12374,71.74581087
5,Western Australia,57350,Quairading,216,46.65226782,279,54.70588235,495,50.87358684
5,Western Australia,57420,Ravensthorpe,741,61.49377593,656,61.19402985,1397,61.352657
5,Western Australia,57490,Rockingham,48143,65.00891217,48405,64.74199502,96548,64.8748169
5,Western Australia,57630,Sandstone,48,64,30,73.17073171,78,67.24137931
5,Western Australia,57700,Serpentine-Jarrahdale,11971,64.82373964,11961,65.46081436,23932,65.1405863
5,Western Australia,57770,Shark Bay,374,62.43739566,367,69.24528302,741,65.63330381
5,Western Australia,57840,South Perth,15827,68.14932828,15611,66.49486732,31438,67.31761633
5,Western Australia,57910,Stirling,80758,67.45009605,81472,65.62859974,162230,66.5228748
5,Western Australia,57980,Subiaco,5898,64.69942957,6302,64.60939102,12200,64.65288818
5,Western Australia,58050,Swan,57649,67.14536963,57721,67.3280377,115370,67.23663659
5,Western Australia,58190,Tammin,153,67.10526316,97,55.11363636,250,61.88118812
5,Western Australia,58260,Three Springs,187,60.12861736,182,64.53900709,369,62.22596965
5,Western Australia,58330,Toodyay,1489,57.96029583,1397,58.57442348,2886,58.25595478
5,Western Australia,58400,Trayning,108,70.12987013,79,53.02013423,187,61.71617162
5,Western Australia,58470,Upper Gascoyne,76,67.25663717,58,65.90909091,134,66.66666667
5,Western Australia,58510,Victoria Park,15273,74.16958042,14348,71.06488361,29621,72.63253396
5,Western Australia,58540,Victoria Plains,247,58.94988067,244,60.24691358,491,59.58737864
5,Western Australia,58570,Vincent,15357,75.334805,14541,73.66261398,29898,74.51214953
5,Western Australia,58610,Wagin,476,54.71264368,515,54.4397463,991,54.57048458
5,Western Australia,58680,Wandering,167,59.43060498,158,59.84848485,325,59.63302752
5,Western Australia,58760,Wanneroo,76081,66.72484257,76621,66.38680945,152702,66.55479912
5,Western Australia,58820,Waroona,1292,58.35591689,1350,60.18724922,2642,59.27754095
5,Western Australia,58890,West Arthur,264,60.41189931,214,61.14285714,478,60.73697586
5,Western Australia,59030,Westonia,69,55.2,64,53.78151261,133,54.50819672
5,Western Australia,59100,Wickepin,213,56.64893617,189,58.15384615,402,57.34664765
5,Western Australia,59170,Williams,302,56.0296846,278,53.35892514,580,54.71698113
5,Western Australia,59250,Wiluna,309,84.89010989,132,64.70588235,441,77.64084507
5,Western Australia,59310,Wongan-Ballidu,384,54.39093484,375,59.52380952,759,56.81137725
5,Western Australia,59320,Woodanilling,146,55.72519084,127,58.52534562,273,56.99373695
5,Western Australia,59330,Wyalkatchem,157,59.92366412,141,61.5720524,298,60.69246436
5,Western Australia,59340,Wyndham-East Kimberley,2760,67.58080313,2869,69.55151515,5629,68.57108052
5,Western Australia,59350,Yalgoo,200,82.6446281,85,73.91304348,285,79.83193277
5,Western Australia,59360,Yilgarn,528,72.82758621,299,63.21353066,827,69.03171953
5,Western Australia,59370,York,949,51.71662125,931,52.68817204,1880,52.19322599
6,Tasmania,60210,Break O`Day,1942,52.77173913,1943,57.23122239,3885,54.91166078
6,Tasmania,60410,Brighton,6089,62.37451342,6622,64.69323955,12711,63.56135614
6,Tasmania,60610,Burnie,6211,62.20330496,6585,62.84596297,12796,62.53237551
6,Tasmania,60810,Central Coast (Tas.),6654,58.30193639,6983,58.59204565,13637,58.45013073
6,Tasmania,61010,Central Highlands (Tas.),864,60.63157895,677,57.86324786,1541,59.38342967
6,Tasmania,61210,Circular Head,2687,61.31903241,2377,59.87405542,5064,60.63218391
6,Tasmania,61410,Clarence,19567,63.04207745,19902,61.00229885,39469,61.99676421
6,Tasmania,61510,Derwent Valley,3642,63.72703412,3561,63.29541415,7203,63.51291773
6,Tasmania,61610,Devonport,8030,60.70456607,8235,59.89526511,16265,60.29210068
6,Tasmania,61810,Dorset,2033,58.0525414,1992,56.93055159,4025,57.49178689
6,Tasmania,62010,Flinders (Tas.),242,50.41666667,229,50.55187638,471,50.48231511
6,Tasmania,62210,George Town,2137,57.61660825,2112,58.32642916,4249,57.96725784
6,Tasmania,62410,Glamorgan-Spring Bay,1451,53.40449025,1415,56.15079365,2866,54.72598816
6,Tasmania,62610,Glenorchy,16853,67.27744511,16755,65.04775215,33608,66.14706345
6,Tasmania,62810,Hobart,19006,69.39028843,19471,68.14236719,38477,68.75312701
6,Tasmania,63010,Huon Valley,5941,60.16811829,5839,60.94989562,11780,60.55309962
6,Tasmania,63210,Kentish,2186,61.232493,2034,62.37350506,4220,61.77719221
6,Tasmania,63410,King Island,522,58.91647856,443,58.13648294,965,58.55582524
6,Tasmania,63610,Kingborough,12296,61.51075538,12943,61.0835811,25239,61.29094927
6,Tasmania,63810,Latrobe (Tas.),3684,56.93972179,3753,56.93264563,7437,56.93615067
6,Tasmania,64010,Launceston,23235,65.29253077,22839,63.08767471,46074,64.180643
6,Tasmania,64210,Meander Valley,6362,59.485741,6395,59.46624512,12757,59.47596625
6,Tasmania,64610,Northern Midlands,4247,59.02710215,4239,59.83907397,8486,59.42993207
6,Tasmania,64810,Sorell,5390,62.06817135,5543,61.92604178,10933,61.99603062
6,Tasmania,65010,Southern Midlands,2280,62.43154436,2121,65.06134969,4401,63.671875
6,Tasmania,65210,Tasman,784,54.86354094,718,57.12012729,1502,55.91958302
6,Tasmania,65410,Waratah-Wynyard,4178,57.43744845,4341,57.9340718,8519,57.68944268
6,Tasmania,65610,West Coast,1462,63.42733189,1275,62.07400195,2737,62.78963065
6,Tasmania,65810,West Tamar,7590,58.62814769,7965,60.83403345,15555,59.7373171
7,Northern Territory,70200,Alice Springs,9685,69.06018254,10913,71.84804793,20598,70.50970458
7,Northern Territory,70420,Barkly,2401,66.67592335,2517,69.18636614,4918,67.93756044
7,Northern Territory,70540,Belyuen,55,68.75,62,72.09302326,117,70.48192771
7,Northern Territory,70620,Central Desert,1426,68.7891944,1383,67.36483195,2809,68.08046534
7,Northern Territory,70700,Coomalie,452,58.77763329,391,59.96932515,843,59.32441942
7,Northern Territory,71000,Darwin,30400,70.3052729,29979,70.9982238,60379,70.64763353
7,Northern Territory,71150,Darwin Waterfront Precinct,122,81.87919463,104,78.19548872,226,80.14184397
7,Northern Territory,71300,East Arnhem,3521,71.95994278,3771,73.68112544,7292,72.83987614
7,Northern Territory,72200,Katherine,3761,67.43769051,3751,71.42041127,7512,69.36928618
7,Northern Territory,72300,Litchfield,9141,70.78912724,7124,67.83469815,16265,69.46401879
7,Northern Territory,72330,MacDonnell,2560,73.49985645,2284,70.86565312,4844,72.23382046
7,Northern Territory,72800,Palmerston,14133,68.53028172,14184,69.22401171,28317,68.87602462
7,Northern Territory,73600,Roper Gulf,2668,71.03301384,2692,72.07496653,5360,71.5525297
7,Northern Territory,74050,Tiwi Islands,990,75.05686126,1044,73.1092437,2034,74.04441209
7,Northern Territory,74550,Victoria Daly,1116,67.26943942,1111,67.90953545,2227,67.58725341
7,Northern Territory,74560,Wagait,140,59.3220339,152,66.66666667,292,62.93103448
7,Northern Territory,74660,West Arnhem,2691,72.72972973,2740,73.91421635,5431,73.32253274
7,Northern Territory,74680,West Daly,1184,68.87725422,1210,70.88459285,2394,69.87740806
7,Northern Territory,79399,Unincorporated NT,2805,70.00249563,2679,72.28818133,5484,71.10073901
8,Australian Capital Territory,89399,Unincorporated ACT,158829,68.959843,160722,68.03191602,319551,68.48998855
9,Other Territories,99399,Unincorp. Other Territories,694,56.69934641,759,58.74613003,1453,57.75039746