S/T code,S/T name,LGA_code,LGA name,Males,Male_Percent,Females,Female_Percent,Overall,Overall_Percent
1,New South Wales,10050,Albury,5071,18.0616897,6221,21.13039639,11292,19.63245649
1,New South Wales,10180,Armidale,2541,17.67652174,3013,19.79762139,5554,18.7673177
1,New South Wales,10250,Ballina,5824,25.33605951,6858,28.23151655,12682,26.82374839
1,New South Wales,10300,Balranald,241,20.72226999,239,23.00288739,480,21.79836512
1,New South Wales,10470,Bathurst,3913,17.28509586,4332,19.7142077,8245,18.48157446
1,New South Wales,10500,Bayside (NSW),11958,12.98089449,14025,15.43464624,25983,14.19936935
1,New South Wales,10550,Bega Valley,5354,29.70319001,5459,29.90577408,10813,29.80512142
1,New South Wales,10600,Bellingen,1819,28.12741611,1890,27.94204613,3709,28.03265059
1,New South Wales,10650,Berrigan,1467,33.73965041,1422,33.10826542,2889,33.42589379
1,New South Wales,10750,Blacktown,21171,9.91258422,25013,11.76390359,46184,10.83617627
1,New South Wales,10800,Bland,584,21.13644589,668,24.7315809,1252,22.9136164
1,New South Wales,10850,Blayney,785,20.53898482,767,20.06802721,1552,20.30350602
1,New South Wales,10900,Blue Mountains,8288,21.67477379,9705,24.13698766,17993,22.93679729
1,New South Wales,10950,Bogan,231,18.84176183,250,20.93802345,481,19.87603306
1,New South Wales,11150,Bourke,174,14.92281304,176,14.67889908,350,14.79915433
1,New South Wales,11200,Brewarrina,126,17.47572816,116,16.8115942,242,17.15095677
1,New South Wales,11250,Broken Hill,1859,21.47147147,2196,24.49252733,4055,23.00839764
1,New South Wales,11300,Burwood,2781,13.20638237,3428,15.98880597,6209,14.6100993
1,New South Wales,11350,Byron,3418,19.05452113,3528,18.38649156,6946,18.70926036
1,New South Wales,11400,Cabonne,1531,21.86518138,1471,21.38703111,3002,21.62824207
1,New South Wales,11450,Camden,5854,8.795072115,7080,10.37347438,12934,9.594172582
1,New South Wales,11500,Campbelltown (NSW),11373,12.45714536,13305,14.23192529,24678,13.35505239
1,New South Wales,11520,Canada Bay,6824,15.33862303,8609,18.35764244,15433,16.88789189
1,New South Wales,11570,Canterbury-Bankstown,26646,13.91930294,30242,16.05227259,56888,14.97726609
1,New South Wales,11600,Carrathool,223,15.02695418,206,16.08118657,429,15.51537071
1,New South Wales,11650,Central Coast (NSW),35165,20.52352049,43049,23.83744753,78214,22.22405337
1,New South Wales,11700,Central Darling,241,26.89732143,148,17.18931475,389,22.14001138
1,New South Wales,11720,Cessnock,5433,15.78855599,5828,17.56479807,11261,16.66050214
1,New South Wales,11730,Clarence Valley,7575,27.02076051,7676,28.12854997,15251,27.56719628
1,New South Wales,11750,Cobar,352,16.94752046,345,17.24137931,697,17.09171162
1,New South Wales,11800,Coffs Harbour,8777,22.33106045,9846,23.90676217,18623,23.13732311
1,New South Wales,12000,Coolamon,517,22.4197745,532,23.71823451,1049,23.06001319
1,New South Wales,12150,Coonamble,372,19.03787103,369,19.34976403,741,19.19191919
1,New South Wales,12160,Cootamundra-Gundagai,1608,27.85380218,1706,30.18934702,3314,29.00910364
1,New South Wales,12350,Cowra,1573,24.81463953,1741,27.54746835,3314,26.17900308
1,New South Wales,12380,Cumberland,14074,11.0207118,15422,13.11193865,29496,12.0233325
1,New South Wales,12390,Dubbo,4574,16.12778111,5217,18.50196829,9791,17.31143251
1,New South Wales,12700,Dungog,1120,22.62626263,1072,22.25451526,2192,22.44292004
1,New South Wales,12730,Edward River,1054,24.97630332,1061,25.20190024,2115,25.08896797
1,New South Wales,12750,Eurobodalla,6611,32.68565213,6900,33.35589287,13511,33.02454048
1,New South Wales,12850,Fairfield,16964,16.31028382,19378,18.32712278,36342,17.32700175
1,New South Wales,12870,Federation,1988,30.54701905,1949,30.30632872,3937,30.42739006
1,New South Wales,12900,Forbes,1055,22.7714224,1098,23.52689094,2153,23.15053763
1,New South Wales,12930,Georges River,12369,15.78665237,14900,18.69510665,27269,17.25329166
1,New South Wales,12950,Gilgandra,533,24.68735526,528,24.55813953,1061,24.62288234
1,New South Wales,13010,Glen Innes Severn,1270,28.48811126,1355,29.90509821,2625,29.20235844
1,New South Wales,13310,Goulburn Mulwaree,3199,19.2028333,3584,22.32882686,6783,20.73677774
1,New South Wales,13340,Greater Hume,1329,22.71018455,1197,21.40175219,2526,22.07077326
1,New South Wales,13450,Griffith,2115,15.35613156,2387,17.8681039,4502,16.59295297
1,New South Wales,13550,Gunnedah,1183,17.73081535,1310,19.82445521,2493,18.77259036
1,New South Wales,13660,Gwydir,708,28.83910387,725,29.1750503,1433,29.00809717
1,New South Wales,13800,Hawkesbury,5383,15.76327272,6193,18.21095657,11576,16.98456482
1,New South Wales,13850,Hay,324,22.73684211,362,25.76512456,686,24.24028269
1,New South Wales,13910,Hilltops,2251,23.6003355,2371,24.40053514,4622,24.00415476
1,New South Wales,14000,Hornsby,12779,16.85039162,15319,19.58100059,28098,18.23692819
1,New South Wales,14100,Hunters Hill,1369,19.61037101,1803,25.55634302,3172,22.59903106
1,New South Wales,14170,Inner West,11448,12.38036531,14002,14.60732766,25450,13.5138723
1,New South Wales,14220,Inverell,2016,22.4724111,2129,23.42649648,4145,22.95254444
1,New South Wales,14300,Junee,664,17.82071927,637,22.79885469,1301,19.95398773
1,New South Wales,14350,Kempsey,4147,25.9025609,4151,26.87949233,8298,26.38222109
1,New South Wales,14400,Kiama,3085,27.38084672,3442,29.33106093,6527,28.37579341
1,New South Wales,14500,Ku-ring-gai,11089,18.01741787,13347,20.39671745,24436,19.24352079
1,New South Wales,14550,Kyogle,1388,29.33840626,1286,27.14798396,2674,28.24250106
1,New South Wales,14600,Lachlan,666,21.49080348,651,21.35826772,1317,21.42508541
1,New South Wales,14650,Lake Macquarie,21940,20.30165633,25733,23.14555806,47673,21.74377078
1,New South Wales,14700,Lane Cove,2698,13.21901029,3284,15.53526657,5982,14.39745842
1,New South Wales,14750,Leeton,999,17.64082642,1093,18.94937587,2092,18.30111101
1,New South Wales,14850,Lismore,4420,20.27895027,4901,22.16543802,9321,21.22896121
1,New South Wales,14870,Lithgow,2548,24.25973531,2650,25.92701301,5198,25.0820305
1,New South Wales,14900,Liverpool,13575,10.97022886,15108,12.19094958,28683,11.58104267
1,New South Wales,14920,Liverpool Plains,964,24.73063109,964,25.57707615,1928,25.14673275
1,New South Wales,14950,Lockhart,439,25.73270809,392,23.19526627,831,24.46996466
1,New South Wales,15050,Maitland,6794,14.4166702,7987,16.35641293,14781,15.40377461
1,New South Wales,15240,Mid-Coast,16026,33.25931306,16905,33.99766712,32931,33.63429307
1,New South Wales,15270,Mid-Western,2619,19.91029345,2752,21.55557296,5371,20.72065121
1,New South Wales,15300,Moree Plains,1077,16.55140618,1076,16.90229343,2153,16.72492814
1,New South Wales,15350,Mosman,2742,20.34728406,3565,22.85989099,6307,21.69516013
1,New South Wales,15520,Murray River,1971,29.55022489,1934,29.05649038,3905,29.30361699
1,New South Wales,15560,Murrumbidgee,421,22.26335272,373,21.73659674,794,22.01275298
1,New South Wales,15650,Muswellbrook,1246,14.32348546,1337,16.54907786,2583,15.39516033
1,New South Wales,15700,Nambucca Valley,3143,30.84396467,3203,30.26266062,6346,30.54780013
1,New South Wales,15750,Narrabri,1292,19.68611915,1268,20.48134389,2560,20.07213423
1,New South Wales,15800,Narrandera,667,23.40350877,677,23.82125264,1344,23.61208714
1,New South Wales,15850,Narromine,689,21.10906863,704,22.14532872,1393,21.62036318
1,New South Wales,15900,Newcastle,13034,15.02790204,15595,17.81023732,28629,16.42569452
1,New South Wales,15950,North Sydney,5442,15.94772008,6722,17.74082871,12164,16.89116005
1,New South Wales,15990,Northern Beaches,22141,16.79638902,26181,19.2364494,48322,18.03591357
1,New South Wales,16100,Oberon,707,24.08038147,692,25.97597598,1399,24.98214286
1,New South Wales,16150,Orange,3601,16.62511542,4327,19.159582,7928,17.91881385
1,New South Wales,16200,Parkes,1424,19.81355225,1537,21.74282077,2961,20.77020202
1,New South Wales,16260,Parramatta,15763,11.60973382,18166,13.62065217,33929,12.60621598
1,New South Wales,16350,Penrith,13732,12.28012126,16001,14.20291141,29733,13.24510097
1,New South Wales,16380,Port Macquarie-Hastings,12283,28.20760133,13707,29.76482595,25990,29.00799143
1,New South Wales,16400,Port Stephens,9823,25.43171521,10578,27.03780385,20401,26.23990328
1,New South Wales,16490,Queanbeyan-Palerang,4368,13.13486694,4438,13.81951797,8806,13.47121724
1,New South Wales,16550,Randwick,9341,13.38482261,11275,15.64842059,20616,14.53468697
1,New South Wales,16610,Richmond Valley,2874,24.36832288,3029,25.43027454,5903,24.90191943
1,New South Wales,16700,Ryde,8972,13.39924431,11097,16.13944762,20069,14.78749742
1,New South Wales,16900,Shellharbour,6852,17.44399185,7713,19.06421474,14565,18.26607138
1,New South Wales,16950,Shoalhaven,14939,27.20039329,15937,28.99059538,30876,28.09590973
1,New South Wales,17000,Singleton,1891,14.37476245,1906,15.65245955,3797,14.98894679
1,New South Wales,17040,Snowy Monaro,2273,19.83247535,2121,19.87630025,4394,19.85360564
1,New South Wales,17080,Snowy Valleys,1787,23.75697953,1794,24.20072845,3581,23.97723468
1,New South Wales,17100,Strathfield,2621,10.58006701,3044,13.20550085,5665,11.8455169
1,New South Wales,17150,Sutherland,20390,17.63825572,24026,20.11756037,44416,18.89809343
1,New South Wales,17200,Sydney,10573,8.696474691,10472,9.56277167,21045,9.106999126
1,New South Wales,17310,Tamworth,5972,18.48344166,6854,20.81005587,12826,19.65791006
1,New South Wales,17350,Temora,769,25.8835409,878,28.71157619,1647,27.31796318
1,New South Wales,17400,Tenterfield,1178,34.26410704,1121,31.71145686,2299,32.97002725
1,New South Wales,17420,The Hills,14130,13.710726,15979,15.23245727,30109,14.47833467
1,New South Wales,17550,Tweed,12232,25.43141087,14095,27.70842753,26327,26.60179656
1,New South Wales,17620,Upper Hunter,1493,20.6357982,1568,22.0751795,3061,21.34886316
1,New South Wales,17640,Upper Lachlan,1149,25.72196105,1039,24.51049776,2188,25.13209281
1,New South Wales,17650,Uralla,674,23.16947405,697,22.21159975,1371,22.67239954
1,New South Wales,17750,Wagga Wagga,5206,15.41787597,6197,17.73104435,11403,16.5943885
1,New South Wales,17850,Walcha,452,30.23411371,429,29.12423625,881,29.68328841
1,New South Wales,17900,Walgett,658,23.90988372,572,20.67220817,1230,22.28664613
1,New South Wales,17950,Warren,296,22.54379284,332,26.14173228,628,24.31281456
1,New South Wales,18020,Warrumbungle,1307,27.99314628,1327,29.10726036,2634,28.54356307
1,New South Wales,18050,Waverley,4019,11.49139361,4784,13.1284303,8803,12.32671465
1,New South Wales,18100,Weddin,576,31.20260022,527,29.7740113,1103,30.50331858
1,New South Wales,18200,Wentworth,877,21.66501976,767,21.07142857,1644,21.38397503
1,New South Wales,18250,Willoughby,5358,14.21182462,6718,16.72267443,12076,15.50710121
1,New South Wales,18350,Wingecarribee,6799,26.32414434,8028,29.42707379,14827,27.91805532
1,New South Wales,18400,Wollondilly,4194,14.46306642,4450,15.54965406,8644,15.00277701
1,New South Wales,18450,Wollongong,18418,16.89027466,21723,19.73096207,40141,18.31743033
1,New South Wales,18500,Woollahra,4910,19.21646902,6094,20.93510598,11004,20.13172338
1,New South Wales,18710,Yass Valley,1559,17.9401611,1671,19.01672926,3230,18.48143274
1,New South Wales,19399,Unincorporated NSW,115,23.18548387,84,16.24758221,199,19.64461994
2,Victoria,20110,Alpine,1701,25.82359192,1802,27.3237301,3503,26.57411622
2,Victoria,20260,Ararat,1458,23.6381323,1447,26.237534,2905,24.86518874
2,Victoria,20570,Ballarat,9904,17.31650173,12211,20.03675566,22115,18.71979143
2,Victoria,20660,Banyule,10817,17.09765119,13286,20.02834057,24103,18.59770683
2,Victoria,20740,Bass Coast,6271,30.02202221,6637,30.38780276,12908,30.20899155
2,Victoria,20830,Baw Baw,6223,21.05922166,6892,22.16504792,13115,21.62621199
2,Victoria,20910,Bayside (Vic.),9834,19.70504549,12327,22.67409778,22161,21.2530689
2,Victoria,21010,Benalla,2079,29.28994083,2244,30.19781994,4323,29.75428453
2,Victoria,21110,Boroondara,13836,16.5091638,17539,19.3311951,31375,17.97613114
2,Victoria,21180,Brimbank,15296,15.51444336,17535,17.99310444,32831,16.74657988
2,Victoria,21270,Buloke,902,28.91952549,898,30.74289627,1800,29.8013245
2,Victoria,21370,Campaspe,4714,24.93124603,4971,25.63560415,9685,25.28786652
2,Victoria,21450,Cardinia,7413,11.77320734,8588,13.41979842,16001,12.6031821
2,Victoria,21610,Casey,19791,10.06279395,22666,11.59771791,42457,10.82782893
2,Victoria,21670,Central Goldfields,2096,30.92813929,2125,31.26379285,4221,31.09621335
2,Victoria,21750,Colac Otway,2644,23.62612814,2826,25.50081213,5470,24.55888295
2,Victoria,21830,Corangamite,1990,24.68676343,2074,26.29643718,4064,25.48281916
2,Victoria,21890,Darebin,9778,12.87375087,12225,15.33299887,22003,14.13320658
2,Victoria,22110,East Gippsland,7684,31.72715636,7801,31.25400641,15485,31.48701682
2,Victoria,22170,Frankston,10773,15.33435819,12979,17.884308,23752,16.63002535
2,Victoria,22250,Gannawarra,1609,30.98998459,1626,31.10175976,3235,31.04606526
2,Victoria,22310,Glen Eira,10963,14.38449629,13784,17.09685822,24747,15.7788022
2,Victoria,22410,Glenelg,2654,26.561249,2711,27.02891326,5365,26.79552492
2,Victoria,22490,Golden Plains,2151,16.1015046,1928,15.4747572,4079,15.79905492
2,Victoria,22620,Greater Bendigo,11536,19.08322443,13252,20.79625881,24788,19.96231095
2,Victoria,22670,Greater Dandenong,11779,14.14215392,13725,17.04926586,25504,15.57096806
2,Victoria,22750,Greater Geelong,25019,18.10412822,30347,20.98482858,55366,19.57717046
2,Victoria,22830,Greater Shepparton,6380,18.50187049,7044,20.32783101,13424,19.41708252
2,Victoria,22910,Hepburn,2307,28.16505921,2493,29.40205213,4800,28.79424115
2,Victoria,22980,Hindmarsh,802,28.58161083,777,28.2237559,1579,28.40438928
2,Victoria,23110,Hobsons Bay,6871,14.95939562,8340,17.44514402,15211,16.22714374
2,Victoria,23190,Horsham,2034,20.27107833,2367,23.02305223,4401,21.66379523
2,Victoria,23270,Hume,13179,9.992720986,15169,11.59018322,28348,10.78838806
2,Victoria,23350,Indigo,2105,24.27912341,2142,23.82117438,4247,24.04597441
2,Victoria,23430,Kingston (Vic.),13329,16.69882235,16788,20.00858124,30117,18.3949818
2,Victoria,23670,Knox,13372,16.80173898,16020,19.49403132,29392,18.16945464
2,Victoria,23810,Latrobe (Vic.),7842,20.45223378,8805,22.11700284,16647,21.30025335
2,Victoria,23940,Loddon,1198,30.10050251,1128,29.94425272,2326,30.02452562
2,Victoria,24130,Macedon Ranges,5045,19.32579966,5424,20.22748462,10469,19.78269085
2,Victoria,24210,Manningham,12659,20.13584017,15535,23.30972602,28194,21.76907516
2,Victoria,24250,Mansfield,1419,27.62312634,1389,25.67942318,2808,26.62620899
2,Victoria,24330,Maribyrnong,4386,9.44261448,5229,11.53973473,9615,10.47819359
2,Victoria,24410,Maroondah,9097,15.94817763,11587,19.18599838,20684,17.61329768
2,Victoria,24600,Melbourne,5300,5.972638554,5969,6.732612962,11269,6.352454396
2,Victoria,24650,Melton,8496,8.229368462,9550,9.287173004,18046,8.757218421
2,Victoria,24700,Merri-bek,9635,10.83960534,12949,14.02378271,22584,12.46199434
2,Victoria,24780,Mildura,5349,18.7631542,6020,20.72574537,11369,19.75362268
2,Victoria,24850,Mitchell,3843,14.11777672,4131,15.58750283,7974,14.84280476
2,Victoria,24900,Moira,4252,27.51747347,4356,28.42785355,8608,27.97075548
2,Victoria,24970,Monash,15410,15.0772452,19157,18.90126587,34567,16.98123403
2,Victoria,25060,Moonee Valley,9493,15.42398492,12060,18.57127458,21553,17.0398305
2,Victoria,25150,Moorabool,3202,16.48051881,3514,17.87112852,6716,17.17998567
2,Victoria,25340,Mornington Peninsula,21743,26.36569779,25595,29.15945133,47338,27.80613594
2,Victoria,25430,Mount Alexander,2881,27.90855372,3157,30.790988,6038,29.34486781
2,Victoria,25490,Moyne,1973,22.63133746,1966,22.10976158,3939,22.36797274
2,Victoria,25620,Murrindindi,2171,26.7991606,1982,26.85272998,4153,26.82469965
2,Victoria,25710,Nillumbik,5385,17.1721037,5776,18.10374549,11161,17.64194487
2,Victoria,25810,Northern Grampians,1617,26.89173458,1589,27.08830549,3206,26.98880377
2,Victoria,25900,Port Phillip,6978,12.99296168,7671,13.74509488,14649,13.37624983
2,Victoria,25990,Pyrenees,1152,28.28382028,997,26.85160248,2149,27.60082199
2,Victoria,26080,Queenscliffe,743,48.53037231,818,47.92032806,1561,48.20877085
2,Victoria,26170,South Gippsland,4125,26.86071498,4263,27.56368809,8388,27.21344451
2,Victoria,26260,Southern Grampians,2023,25.00308985,2297,27.41377253,4320,26.2295082
2,Victoria,26350,Stonnington,7950,14.89377646,10171,17.54921752,18121,16.27610365
2,Victoria,26430,Strathbogie,1867,32.35701906,1861,32.04201102,3728,32.1989981
2,Victoria,26490,Surf Coast,3898,19.93352084,4076,20.65156812,7974,20.29420747
2,Victoria,26610,Swan Hill,1977,18.45076995,2185,20.81547109,4162,19.62096926
2,Victoria,26670,Towong,959,30.02504696,888,29.12430305,1847,29.58513535
2,Victoria,26700,Wangaratta,3479,23.93697537,3875,25.05171968,7354,24.51169922
2,Victoria,26730,Warrnambool,3450,19.79118862,4212,22.79837618,7662,21.33845768
2,Victoria,26810,Wellington,5411,23.15361575,5554,24.40889514,10965,23.77287312
2,Victoria,26890,West Wimmera,557,27.82217782,547,28.32729156,1104,28.07017544
2,Victoria,26980,Whitehorse,13807,15.81177495,17891,19.5919753,31698,17.74416561
2,Victoria,27070,Whittlesea,14213,11.62047257,16860,13.73870387,31073,12.68135608
2,Victoria,27170,Wodonga,3659,16.91084716,4316,19.06444631,7975,18.01201554
2,Victoria,27260,Wyndham,11360,6.899358044,13025,8.169524694,24385,7.524214177
2,Victoria,27350,Yarra,4962,10.35086987,6043,12.20561503,11005,11.29320253
2,Victoria,27450,Yarra Ranges,13385,17.01800336,15268,19.07498563,28653,18.05550304
2,Victoria,27630,Yarriambiack,938,28.7377451,966,30.912,1904,29.80122085
2,Victoria,29399,Unincorporated Vic,75,15.12096774,40,8.75273523,115,12.06715635
3,Queensland,30250,Aurukun,25,4.716981132,38,6.08974359,63,5.459272097
3,Queensland,30300,Balonne,374,16.88487585,360,16.90140845,734,16.89298044
3,Queensland,30370,Banana,1281,16.66233091,1144,15.82077168,2425,16.25444065
3,Queensland,30410,Barcaldine,285,19.70954357,278,19.19889503,563,19.45404285
3,Queensland,30450,Barcoo,24,15,12,7.643312102,36,11.35646688
3,Queensland,30760,Blackall Tambo,269,27.22672065,250,25.90673575,519,26.57450077
3,Queensland,30900,Boulia,38,16.52173913,32,12.90322581,70,14.64435146
3,Queensland,31000,Brisbane,79188,12.05917199,95618,14.34628657,174806,13.21123188
3,Queensland,31750,Bulloo,27,13.91752577,24,15.78947368,51,14.73988439
3,Queensland,31820,Bundaberg,13330,25.98440546,14068,26.61067605,27398,26.30224833
3,Queensland,31900,Burdekin,2039,23.43678161,2085,25.06009615,4124,24.23031727
3,Queensland,31950,Burke,40,15.38461538,31,17.41573034,71,16.21004566
3,Queensland,32080,Cairns,13817,15.91013772,14131,15.95749486,27948,15.93404714
3,Queensland,32250,Carpentaria,162,13.91752577,105,10.01908397,267,12.07052441
3,Queensland,32260,Cassowary Coast,3723,24.2588128,3402,23.26153846,7125,23.77218737
3,Queensland,32270,Central Highlands (Qld),1596,10.54579093,1389,10.03685237,2985,10.30269561
3,Queensland,32310,Charters Towers,1352,22.46220302,1270,21.18785452,2622,21.82635478
3,Queensland,32330,Cherbourg,49,7.753164557,53,8.386075949,102,8.069620253
3,Queensland,32450,Cloncurry,238,10.82802548,175,10.58681186,413,10.72448715
3,Queensland,32500,Cook,518,20.46621889,332,14.88789238,850,17.85339214
3,Queensland,32600,Croydon,28,20.4379562,5,3.759398496,33,12.22222222
3,Queensland,32750,Diamantina,20,12.5,16,14.28571429,36,13.23529412
3,Queensland,32770,Doomadgee,35,4.672897196,33,4.634831461,68,4.654346338
3,Queensland,32810,Douglas,1443,22.11494253,1235,19.5938442,2678,20.87620829
3,Queensland,33100,Etheridge,88,23.40425532,83,23.71428571,171,23.55371901
3,Queensland,33200,Flinders (Qld),162,21.34387352,157,20,319,20.66062176
3,Queensland,33220,Fraser Coast,17395,30.08734757,18427,30.64781705,35822,30.37307105
3,Queensland,33360,Gladstone,5081,15.00546351,4698,14.24758901,9779,14.63155532
3,Queensland,33430,Gold Coast,54113,16.63331581,62771,18.42099085,116884,17.54785786
3,Queensland,33610,Goondiwindi,1063,20.27465192,1005,19.29353043,2068,19.78568695
3,Queensland,33620,Gympie,7219,25.92659101,7191,25.39015606,14410,25.65609087
3,Queensland,33800,Hinchinbrook,1656,29.27864215,1616,29.58623215,3272,29.42975355
3,Queensland,33830,Hope Vale,40,7.547169811,38,7.661290323,78,7.602339181
3,Queensland,33960,Ipswich,13289,10.6237209,15219,12.07282247,28508,11.35107586
3,Queensland,33980,Isaac,963,7.423681776,676,6.725029845,1639,7.118658791
3,Queensland,34420,Kowanyama,38,6.643356643,34,5.913043478,72,6.277244987
3,Queensland,34530,Livingstone,4426,20.55258881,4366,21.43242845,8792,20.98028922
3,Queensland,34570,Lockhart River,30,8.474576271,32,10.03134796,62,9.212481426
3,Queensland,34580,Lockyer Valley,3814,17.44978725,3860,17.55343338,7674,17.50176751
3,Queensland,34590,Logan,22895,12.21750847,26248,13.78730736,49143,13.0086057
3,Queensland,34710,Longreach,338,18.25053996,321,17.02917772,659,17.63446615
3,Queensland,34770,Mackay,9856,15.40216593,10130,16.10083286,19986,15.74854027
3,Queensland,34800,McKinlay,62,13.5371179,49,12.53196931,111,13.07420495
3,Queensland,34830,Mapoon,25,11.26126126,26,10.69958848,51,10.96774194
3,Queensland,34860,Maranoa,1102,16.53413353,1062,16.11532625,2164,16.32591475
3,Queensland,34880,Mareeba,2534,20.24123333,2418,21.62210498,4952,20.89275167
3,Queensland,35010,Moreton Bay,42150,16.80307119,48367,18.65600543,90517,17.74481282
3,Queensland,35250,Mornington,41,8.08678501,42,7.342657343,83,7.692307692
3,Queensland,35300,Mount Isa,816,8.35209826,723,7.880108992,1539,8.123515439
3,Queensland,35600,Murweh,408,21.4849921,407,19.69037252,815,20.54967221
3,Queensland,35670,Napranum,29,6.318082789,35,7.52688172,64,6.926406926
3,Queensland,35740,Noosa,7880,27.76896783,8468,28.23607869,16348,28.00897768
3,Queensland,35760,North Burnett,1464,27.5862069,1356,26.87809713,2820,27.24111283
3,Queensland,35780,Northern Peninsula Area,80,5.528680028,72,4.928131417,152,5.22696011
3,Queensland,35790,Palm Island,77,7.169459963,67,5.877192982,144,6.504065041
3,Queensland,35800,Paroo,182,20.42648709,153,18.34532374,335,19.42028986
3,Queensland,36070,Pormpuraaw,27,8.333333333,32,10,59,9.161490683
3,Queensland,36150,Quilpie,63,18.5840708,69,18.64864865,132,18.61777151
3,Queensland,36250,Redland,16480,20.1068788,19086,22.49460794,35566,21.32139153
3,Queensland,36300,Richmond,68,16.83168317,42,11.14058355,110,14.08450704
3,Queensland,36370,Rockhampton,6714,16.10612676,7457,17.41028694,14171,16.76704095
3,Queensland,36510,Scenic Rim,5247,23.26313456,5233,23.05997444,10480,23.1612447
3,Queensland,36580,Somerset,3025,22.59654889,2727,21.19869403,5752,21.91154623
3,Queensland,36630,South Burnett,4632,27.01189643,4547,26.52549294,9179,26.76873724
3,Queensland,36660,Southern Downs,4923,26.65114768,5157,27.18216319,10080,26.92020083
3,Queensland,36720,Sunshine Coast,36748,20.78988906,42228,22.32124451,78976,21.58156211
3,Queensland,36820,Tablelands,3619,26.9070632,3674,26.60583677,7293,26.75446641
3,Queensland,36910,Toowoomba,16449,18.60725557,19453,20.8231642,35902,19.74579394
3,Queensland,36950,Torres,152,8.750719632,156,8.838526912,308,8.7949743
3,Queensland,36960,Torres Strait Island,163,7.641819034,195,9.057129587,358,8.352776482
3,Queensland,37010,Townsville,14026,13.86639776,15442,15.39857602,29468,14.62918191
3,Queensland,37300,Weipa,80,3.550821127,67,3.353353353,147,3.45800988
3,Queensland,37310,Western Downs,3105,17.43011115,3044,17.7213716,6149,17.57309022
3,Queensland,37340,Whitsunday,3526,17.21679688,3161,16.43614809,6687,16.83873892
3,Queensland,37400,Winton,135,24.68007313,121,20.47377327,256,22.49560633
3,Queensland,37550,Woorabinda,30,5.952380952,36,6.239168111,66,6.105457909
3,Queensland,37570,Wujal Wujal,13,9.62962963,13,8.227848101,26,8.873720137
3,Queensland,37600,Yarrabah,65,5.086071987,102,7.488986784,167,6.325757576
4,South Australia,40070,Adelaide,1911,13.31150738,2241,16.5448505,4152,14.88118705
4,South Australia,40120,Adelaide Hills,4172,20.24456522,4410,20.76857869,8582,20.51049185
4,South Australia,40150,Adelaide Plains,808,14.24039478,752,14.30201598,1560,14.27003293
4,South Australia,40220,Alexandrina,5029,33.40640361,5064,33.16523675,10093,33.28496521
4,South Australia,40250,Anangu Pitjantjatjara Yankunytjatjara,50,4.038772213,62,4.447632712,112,4.255319149
4,South Australia,40310,Barossa,2923,22.31468051,3168,24.05649632,6091,23.18790924
4,South Australia,40430,Barunga West,469,33.19179052,433,34.17521705,902,33.65671642
4,South Australia,40520,Berri Barmera,1300,23.55072464,1333,25.58541267,2633,24.53867661
4,South Australia,40700,Burnside,4861,21.36891155,6176,25.00809848,11037,23.26321558
4,South Australia,40910,Campbelltown (SA),4764,17.16818624,6530,22.20257727,11294,19.75857243
4,South Australia,41010,Ceduna,355,18.54754441,369,20.46589018,724,19.47807372
4,South Australia,41060,Charles Sturt,11020,17.7304394,13823,21.17266837,24843,19.49387947
4,South Australia,41140,Clare and Gilbert Valleys,1231,26.32591959,1224,25.8828505,2455,26.10313663
4,South Australia,41190,Cleve,212,22.74678112,220,26.66666667,432,24.58736483
4,South Australia,41330,Coober Pedy,309,34.14364641,162,25.11627907,471,30.38709677
4,South Australia,41560,Copper Coast,2673,33.06940492,2662,33.8332486,5335,33.44617892
4,South Australia,41750,Elliston,112,20.4007286,103,20.93495935,215,20.65321806
4,South Australia,41830,Flinders Ranges,275,31.71856978,257,31.88585608,532,31.79916318
4,South Australia,41960,Franklin Harbour,210,30.34682081,202,31.5625,412,30.93093093
4,South Australia,42030,Gawler,2560,19.68625038,3135,22.74211099,5695,21.2587256
4,South Australia,42110,Goyder,610,28.61163227,582,29.1,1192,28.84801549
4,South Australia,42250,Grant,1012,19.92910595,811,20.44881493,1823,20.15701017
4,South Australia,42600,Holdfast Bay,4671,25.25957171,5838,28.79550163,10509,27.10880669
4,South Australia,42750,Kangaroo Island,759,28.26815642,698,28.60655738,1457,28.42926829
4,South Australia,43080,Karoonda East Murray,162,28.57142857,137,30.51224944,299,29.42913386
4,South Australia,43220,Kimba,121,21.88065099,121,23.91304348,242,22.85174693
4,South Australia,43360,Kingston (SA),401,33.00411523,369,31.32427844,770,32.17718345
4,South Australia,43650,Light,1372,16.27713845,1341,16.37962624,2713,16.32763601
4,South Australia,43710,Lower Eyre Peninsula,698,21.34556575,568,19.69486824,1266,20.5719857
4,South Australia,43790,Loxton Waikerie,1616,26.57894737,1553,26.69761045,3169,26.6369673
4,South Australia,44000,Maralinga Tjarutja,11,18.6440678,5,11.62790698,16,15.68627451
4,South Australia,44060,Marion,8051,16.98953322,10383,20.31699442,18434,18.71605089
4,South Australia,44210,Mid Murray,1600,31.37254902,1356,30.84622384,2956,31.12889638
4,South Australia,44340,Mitcham,6500,19.31419742,7949,22.149465,14449,20.77737195
4,South Australia,44550,Mount Barker,3445,16.81307955,4042,18.53533269,7487,17.70101898
4,South Australia,44620,Mount Gambier,2783,20.34654189,3168,22.36024845,5951,21.37111255
4,South Australia,44830,Mount Remarkable,485,33.01565691,449,31.44257703,934,32.24024853
4,South Australia,45040,Murray Bridge,2525,21.56829247,2607,23.2892621,5132,22.40950177
4,South Australia,45090,Naracoorte Lucindale,895,18.95383312,913,21.70708512,1808,20.25089606
4,South Australia,45120,Northern Areas,631,26.19344126,626,27.72364925,1257,26.93379044
4,South Australia,45290,Norwood Payneham and St Peters,3419,17.90614853,4661,23.05371451,8080,20.55352055
4,South Australia,45340,Onkaparinga,16681,18.885505,19688,21.27558408,36369,20.10836812
4,South Australia,45400,Orroroo Carrieton,120,27.21088435,142,31.69642857,262,29.47131609
4,South Australia,45540,Peterborough,278,31.84421535,265,32.71604938,543,32.26381462
4,South Australia,45680,Playford,6080,11.49468749,7173,13.24042455,13253,12.37799923
4,South Australia,45890,Port Adelaide Enfield,9554,13.86607065,12105,17.37152534,21659,15.62867554
4,South Australia,46090,Port Augusta,1283,16.87269858,1241,18.20715962,2524,17.50346741
4,South Australia,46300,Port Lincoln,1522,20.22322615,1666,22.23705286,3188,21.2278599
4,South Australia,46450,Port Pirie,1955,22.13291068,2137,24.36993956,4092,23.24735825
4,South Australia,46510,Prospect,1585,13.68621017,1920,16.61474559,3505,15.14889571
4,South Australia,46670,Renmark Paringa,1157,22.14777948,1184,24.2473889,2341,23.16216484
4,South Australia,46860,Robe,223,27.875,256,31.88044832,479,29.88147224
4,South Australia,46970,Roxby Downs,40,1.761338617,34,1.845819761,74,1.799173353
4,South Australia,47140,Salisbury,10577,14.14113054,12743,17.12354538,23320,15.62856032
4,South Australia,47290,Southern Mallee,233,22.36084453,246,25.36082474,479,23.80715706
4,South Australia,47490,Streaky Bay,325,28.31010453,261,23.09734513,586,25.72431958
4,South Australia,47630,Tatiara,701,19.10602344,703,20.69473064,1404,19.86979904
4,South Australia,47700,Tea Tree Gully,9569,18.81328274,11631,22.01923441,21200,20.44654482
4,South Australia,47800,Coorong,783,25.90142243,714,27.57821553,1497,26.67498218
4,South Australia,47910,Tumby Bay,447,30.82758621,464,31.86813187,911,31.34893324
4,South Australia,47980,Unley,3773,19.94924126,5013,23.85325466,8786,22.0040572
4,South Australia,48050,Victor Harbor,3296,40.93392946,3841,43.56357038,7137,42.30837631
4,South Australia,48130,Wakefield,820,22.81580412,771,22.91914388,1591,22.86576602
4,South Australia,48260,Walkerville,863,21.9146775,1107,24.69879518,1970,23.39667458
4,South Australia,48340,Wattle Range,1612,25.45397126,1499,25.30384875,3111,25.3814147
4,South Australia,48410,West Torrens,4817,15.28381508,6369,19.29883037,11186,17.33752848
4,South Australia,48540,Whyalla,1959,17.45367071,2200,20.6031092,4159,18.98913341
4,South Australia,48640,Wudinna,134,23.1433506,129,22.16494845,263,22.65288544
4,South Australia,48750,Yankalilla,1108,35.97402597,989,32.74834437,2097,34.37704918
4,South Australia,48830,Yorke Peninsula,2288,36.56704491,2066,35.72540204,4354,36.1627907
4,South Australia,49399,Unincorporated SA,284,16.32183908,197,15.45098039,481,15.95356551
5,Western Australia,50080,Albany,4610,22.80371983,5046,24.33801187,9656,23.58055142
5,Western Australia,50210,Armadale,5873,11.20630438,6622,12.56880386,12495,11.8893562
5,Western Australia,50250,Ashburton,158,3.338263258,126,3.769069698,284,3.516592372
5,Western Australia,50280,Augusta Margaret River,1683,18,1687,18.19848975,3370,18.09881847
5,Western Australia,50350,Bassendean,1327,15.7882213,1665,19.56751675,2992,17.689488
5,Western Australia,50420,Bayswater,5711,15.34019179,6833,18.44065418,12544,16.88677086
5,Western Australia,50490,Belmont,2961,12.56737829,3480,15.52531787,6441,14.00948321
5,Western Australia,50560,Beverley,333,37.12374582,264,30.30998852,597,33.76696833
5,Western Australia,50630,Boddington,161,17.33046286,164,19.13652275,325,18.19708847
5,Western Australia,50770,Boyup Brook,250,25.27805865,218,22.73201251,468,24.02464066
5,Western Australia,50840,Bridgetown-Greenbushes,811,28.55633803,756,26.72322375,1567,27.64155936
5,Western Australia,50910,Brookton,130,26.20967742,122,26.5795207,252,26.38743455
5,Western Australia,50980,Broome,773,8.508530545,700,7.348309889,1473,7.914674117
5,Western Australia,51080,Broomehill-Tambellup,100,17.76198934,81,15.22556391,181,16.52968037
5,Western Australia,51120,Bruce Rock,126,23.46368715,143,28.26086957,269,25.79098754
5,Western Australia,51190,Bunbury,3422,19.77120407,3945,22.59450172,7367,21.18902439
5,Western Australia,51260,Busselton,4977,23.15853148,5517,24.54399858,10494,23.86681526
5,Western Australia,51310,Cambridge,2560,16.70473083,3010,19.0409919,5570,17.89098384
5,Western Australia,51330,Canning,6819,12.96363187,8043,15.74280681,14862,14.33297007
5,Western Australia,51400,Capel,1448,15.21647751,1431,14.57378552,2879,14.89009568
5,Western Australia,51470,Carnamah,97,31.49350649,61,22.50922509,158,27.28842832
5,Western Australia,51540,Carnarvon,527,18.31132731,420,15.8490566,947,17.13096961
5,Western Australia,51610,Chapman Valley,161,18.6774942,142,17.7278402,303,18.22008419
5,Western Australia,51680,Chittering,559,16.8627451,563,17.58825367,1122,17.21915285
9,Other Territories,51710,Christmas Island,157,14.63187325,88,11.73333333,245,13.43938563
5,Western Australia,51750,Claremont,1287,21.77664975,1618,25.81365667,2905,23.85449171
5,Western Australia,51820,Cockburn,8179,12.62093974,9404,14.36229516,17583,13.49610844
9,Other Territories,51860,Cocos Islands,71,21.71253823,50,16.44736842,121,19.17591125
5,Western Australia,51890,Collie,1109,23.53565365,1026,22.3870827,2135,22.96933835
5,Western Australia,51960,Coolgardie,271,13.48258706,196,11.69451074,467,12.6695605
5,Western Australia,52030,Coorow,208,34.7826087,141,27.70137525,349,31.5266486
5,Western Australia,52100,Corrigin,147,27.27272727,134,27.34693878,281,27.30806608
5,Western Australia,52170,Cottesloe,948,21.94952535,982,22.44058501,1930,22.19666475
5,Western Australia,52240,Cranbrook,152,24.79608483,131,24.44029851,283,24.63011314
5,Western Australia,52310,Cuballing,152,29.34362934,96,22.17090069,248,26.07781283
5,Western Australia,52380,Cue,46,30.66666667,32,39.50617284,78,33.76623377
5,Western Australia,52450,Cunderdin,135,19.59361393,112,17.69352291,247,18.68381241
5,Western Australia,52520,Dalwallinu,121,16.57534247,125,17.45810056,246,17.01244813
5,Western Australia,52590,Dandaragan,569,28.16831683,457,26.44675926,1026,27.37459979
5,Western Australia,52660,Dardanup,1357,17.41082884,1570,19.89608415,2927,18.66114122
5,Western Australia,52730,Denmark,919,28.29433498,925,27.44807122,1844,27.86340284
5,Western Australia,52800,Derby-West Kimberley,367,8.54283054,327,7.904278463,694,8.229574291
5,Western Australia,52870,Donnybrook-Balingup,816,25.68460812,834,25.574977,1650,25.62907735
5,Western Australia,52940,Dowerin,99,25.78125,84,23.72881356,183,24.79674797
5,Western Australia,53010,Dumbleyung,84,23.26869806,55,16.17647059,139,19.82881598
5,Western Australia,53080,Dundas,92,25.13661202,73,21.79104478,165,23.53780314
5,Western Australia,53150,East Fremantle,771,19.69348659,865,20.08358486,1636,19.89783508
5,Western Australia,53220,East Pilbara,229,3.376087277,129,3.565505804,358,3.441976733
5,Western Australia,53290,Esperance,1425,19.21521036,1468,20.58617305,2893,19.88726198
5,Western Australia,53360,Exmouth,222,12.26519337,181,10.92995169,403,11.62723601
5,Western Australia,53430,Fremantle,3173,18.26607564,3599,20.2350163,6772,19.26216685
5,Western Australia,53570,Gingin,873,27.48740554,722,25,1595,26.30277045
5,Western Australia,53640,Gnowangerup,116,16.83599419,79,13.62068966,195,15.36643026
5,Western Australia,53710,Goomalling,123,24.5508982,128,26.33744856,251,25.43059777
5,Western Australia,53780,Gosnells,8765,12.58037662,9875,14.59007432,18640,13.57067453
5,Western Australia,53800,Greater Geraldton,3565,17.17492894,3936,18.6037718,7501,17.89616834
5,Western Australia,53920,Halls Creek,121,5.836951278,147,7.125545322,268,6.479690522
5,Western Australia,53990,Harvey,2721,17.71253743,2958,19.17293233,5679,18.4443001
5,Western Australia,54060,Irwin,626,32.84365163,605,31.25,1231,32.04060385
5,Western Australia,54130,Jerramungup,107,16.58914729,98,17.25352113,205,16.90024732
5,Western Australia,54170,Joondalup,14788,17.44567397,16467,19.39781602,31255,18.42246415
5,Western Australia,54200,Kalamunda,5536,17.69764394,6313,20.1121412,11849,18.90697303
5,Western Australia,54280,Kalgoorlie-Boulder,1545,9.429931641,1356,9.422555764,2901,9.426482535
5,Western Australia,54310,Karratha,488,3.672210099,346,3.160394593,834,3.441019928
5,Western Australia,54340,Katanning,362,16.33574007,413,19.91321119,775,18.06526807
5,Western Australia,54410,Kellerberrin,152,25.04118616,160,28.62254025,312,26.75814751
5,Western Australia,54480,Kent,50,16.89189189,23,10.0877193,73,13.93129771
5,Western Australia,54550,Kojonup,229,23.63261094,216,21.64328657,445,22.62328419
5,Western Australia,54620,Kondinin,103,22.39130435,75,18.84422111,178,20.74592075
5,Western Australia,54690,Koorda,56,27.45098039,43,25.74850299,99,26.68463612
5,Western Australia,54760,Kulin,88,22.62210797,82,20.24691358,170,21.41057935
5,Western Australia,54830,Kwinana,2330,8.622603804,2547,10.15509748,4877,9.360305549
5,Western Australia,54900,Lake Grace,128,17.87709497,112,19.14529915,240,18.44734819
5,Western Australia,54970,Laverton,68,6.772908367,33,7.586206897,101,7.01876303
5,Western Australia,55040,Leonora,79,7.335190344,56,8.549618321,135,7.794457275
5,Western Australia,55110,Mandurah,11961,24.93589343,13493,26.29958094,25454,25.64066403
5,Western Australia,55180,Manjimup,1123,23.73203719,1066,22.6519337,2189,23.19347319
5,Western Australia,55250,Meekatharra,79,9.875,44,8.906882591,123,9.505409583
5,Western Australia,55320,Melville,10538,19.63992843,12609,22.21067465,23147,20.96154891
5,Western Australia,55390,Menzies,38,9.112709832,23,14.55696203,61,10.60869565
5,Western Australia,55460,Merredin,343,20.52663076,308,19.28616155,651,19.92044064
5,Western Australia,55530,Mingenew,58,25.2173913,47,25.13368984,105,25.17985612
5,Western Australia,55600,Moora,231,18.85714286,259,22.19365895,490,20.48494983
5,Western Australia,55670,Morawa,81,22.31404959,76,24.05063291,157,23.12223859
5,Western Australia,55740,Mosman Park,910,18.89534884,1013,19.42101227,1923,19.16866029
5,Western Australia,55810,Mount Magnet,63,16.71087533,41,12.65432099,104,14.83594864
5,Western Australia,55880,Mount Marshall,44,17.95918367,39,18.05555556,83,18.00433839
5,Western Australia,55950,Mukinbudin,77,23.05389222,67,25.18796992,144,24
5,Western Australia,56090,Mundaring,4039,18.61204553,4347,22.04361055,8386,20.24576905
5,Western Australia,56160,Murchison,7,12.28070175,5,10.20408163,12,11.32075472
5,Western Australia,56230,Murray,2429,24.57755742,2437,24.51710262,4866,24.5472431
5,Western Australia,56300,Nannup,284,33.68920522,257,32.57287706,541,33.1495098
5,Western Australia,56370,Narembeen,115,25.33039648,93,24.53825858,208,24.969988
5,Western Australia,56460,Narrogin,543,21.81599036,517,20.7297514,1060,21.27232591
5,Western Australia,56580,Nedlands,2333,19.34173437,2560,21.21840033,4893,20.28018403
5,Western Australia,56620,Ngaanyatjarraku,39,5.660377358,53,6.708860759,92,6.220419202
5,Western Australia,56730,Northam,1219,19.66446201,1299,21.67167167,2518,20.65119331
5,Western Australia,56790,Northampton,581,32.36768802,475,30.17789072,1056,31.34461264
5,Western Australia,56860,Nungarin,34,25.37313433,31,25.40983607,65,25.390625
5,Western Australia,56930,Peppermint Grove,165,21.484375,201,20.76446281,366,21.08294931
5,Western Australia,57000,Perenjori,60,15.03759398,43,17.2,103,15.87057011
5,Western Australia,57080,Perth,1816,10.31876811,1681,11.01789343,3497,10.64341368
5,Western Australia,57140,Pingelly,163,29.85347985,165,30.66914498,328,30.25830258
5,Western Australia,57210,Plantagenet,737,25.40503275,658,23.7716763,1395,24.60751455
5,Western Australia,57280,Port Hedland,384,4.194429274,343,4.238754325,727,4.215225836
5,Western Australia,57350,Quairading,163,35.20518359,136,26.66666667,299,30.72970195
5,Western Australia,57420,Ravensthorpe,231,19.17012448,190,17.7238806,421,18.48924023
5,Western Australia,57490,Rockingham,9829,13.27238846,11237,15.02955889,21066,14.15516523
5,Western Australia,57630,Sandstone,27,36,10,24.3902439,37,31.89655172
5,Western Australia,57700,Serpentine-Jarrahdale,1916,10.37526398,1865,10.20687391,3781,10.29151583
5,Western Australia,57770,Shark Bay,126,21.03505843,97,18.30188679,223,19.75199291
5,Western Australia,57840,South Perth,4051,17.44316225,4884,20.80333944,8935,19.13235263
5,Western Australia,57910,Stirling,18094,15.11233609,22969,18.50234814,41063,16.83800042
5,Western Australia,57980,Subiaco,1788,19.61386573,2079,21.31433258,3867,20.49284579
5,Western Australia,58050,Swan,9391,10.93795497,10390,12.1193034,19781,11.52819544
5,Western Australia,58190,Tammin,40,17.54385965,45,25.56818182,85,21.03960396
5,Western Australia,58260,Three Springs,63,20.25723473,45,15.95744681,108,18.21247892
5,Western Australia,58330,Toodyay,715,27.83184118,638,26.75052411,1353,27.31126363
5,Western Australia,58400,Trayning,39,25.32467532,50,33.55704698,89,29.37293729
5,Western Australia,58470,Upper Gascoyne,14,12.38938053,9,10.22727273,23,11.44278607
5,Western Australia,58510,Victoria Park,2547,12.36888112,3158,15.64140664,5705,13.98901476
5,Western Australia,58540,Victoria Plains,106,25.29832936,82,20.24691358,188,22.81553398
5,Western Australia,58570,Vincent,2172,10.6548933,2492,12.62411348,4664,11.62367601
5,Western Australia,58610,Wagin,234,26.89655172,268,28.32980973,502,27.64317181
5,Western Australia,58680,Wandering,77,27.40213523,56,21.21212121,133,24.40366972
5,Western Australia,58760,Wanneroo,12904,11.31711424,15046,13.03632079,27950,12.18194022
5,Western Australia,58820,Waroona,558,25.20325203,516,23.00490415,1074,24.09692618
5,Western Australia,58890,West Arthur,110,25.17162471,82,23.42857143,192,24.39644219
5,Western Australia,59030,Westonia,40,32,33,27.73109244,73,29.91803279
5,Western Australia,59100,Wickepin,91,24.20212766,56,17.23076923,147,20.9700428
5,Western Australia,59170,Williams,116,21.52133581,123,23.6084453,239,22.54716981
5,Western Australia,59250,Wiluna,31,8.516483516,21,10.29411765,52,9.154929577
5,Western Australia,59310,Wongan-Ballidu,173,24.50424929,141,22.38095238,314,23.50299401
5,Western Australia,59320,Woodanilling,59,22.51908397,45,20.73732719,104,21.71189979
5,Western Australia,59330,Wyalkatchem,77,29.38931298,63,27.51091703,140,28.51323829
5,Western Australia,59340,Wyndham-East Kimberley,393,9.622918707,291,7.054545455,684,8.332318187
5,Western Australia,59350,Yalgoo,24,9.917355372,23,20,47,13.16526611
5,Western Australia,59360,Yilgarn,125,17.24137931,92,19.45031712,217,18.11352254
5,Western Australia,59370,York,607,33.07901907,571,32.31465761,1178,32.7040533
6,Tasmania,60210,Break O`Day,1278,34.72826087,1057,31.13402062,2335,33.00353357
6,Tasmania,60410,Brighton,1361,13.9418152,1495,14.60531458,2856,14.28142814
6,Tasmania,60610,Burnie,1861,18.63795694,2066,19.71750334,3927,19.1907345
6,Tasmania,60810,Central Coast (Tas.),2845,24.92771401,3145,26.38865581,5990,25.67399597
6,Tasmania,61010,Central Highlands (Tas.),410,28.77192982,296,25.2991453,706,27.2061657
6,Tasmania,61210,Circular Head,867,19.78548608,821,20.68010076,1688,20.21072797
6,Tasmania,61410,Clarence,5997,19.3214769,7411,22.71570881,13408,21.0608988
6,Tasmania,61510,Derwent Valley,1054,18.44269466,1125,19.99644508,2179,19.21347324
6,Tasmania,61610,Devonport,2903,21.94587239,3303,24.02356535,6206,23.00478185
6,Tasmania,61810,Dorset,904,25.81382067,960,27.4364104,1864,26.62476789
6,Tasmania,62010,Flinders (Tas.),188,39.16666667,165,36.42384106,353,37.83494105
6,Tasmania,62210,George Town,973,26.23348611,961,26.53962994,1934,26.38472033
6,Tasmania,62410,Glamorgan-Spring Bay,1005,36.98932646,882,35,1887,36.03207943
6,Tasmania,62610,Glenorchy,3927,15.67664671,5028,19.52014908,8955,17.62517714
6,Tasmania,62810,Hobart,4595,16.77619569,5582,19.53524183,10177,18.18490458
6,Tasmania,63010,Huon Valley,2258,22.86813855,2179,22.74530271,4437,22.80764881
6,Tasmania,63210,Kentish,867,24.28571429,747,22.90708372,1614,23.62758015
6,Tasmania,63410,King Island,210,23.7020316,171,22.44094488,381,23.11893204
6,Tasmania,63610,Kingborough,4003,20.02501251,4688,22.12468734,8691,21.10541781
6,Tasmania,63810,Latrobe (Tas.),1764,27.26429675,1911,28.98968447,3675,28.13504823
6,Tasmania,64010,Launceston,6139,17.25116619,7402,20.44638418,13541,18.86248398
6,Tasmania,64210,Meander Valley,2503,23.40345956,2698,25.08833922,5201,24.2482167
6,Tasmania,64610,Northern Midlands,1732,24.07227241,1745,24.63297572,3477,24.35044471
6,Tasmania,64810,Sorell,1778,20.47443574,1854,20.71276952,3632,20.59540686
6,Tasmania,65010,Southern Midlands,766,20.97480832,614,18.83435583,1380,19.96527778
6,Tasmania,65210,Tasman,509,35.61931421,413,32.85600636,922,34.32613552
6,Tasmania,65410,Waratah-Wynyard,1819,25.0068738,1975,26.35793407,3794,25.69242229
6,Tasmania,65610,West Coast,519,22.51626898,451,21.95715677,970,22.25281028
6,Tasmania,65810,West Tamar,3034,23.43581029,3172,24.22668602,6206,23.83348055
7,Northern Territory,70200,Alice Springs,1367,9.747575585,1487,9.78997959,2854,9.769623113
7,Northern Territory,70420,Barkly,274,7.608997501,256,7.036833425,530,7.321453239
7,Northern Territory,70540,Belyuen,6,7.5,3,3.488372093,9,5.421686747
7,Northern Territory,70620,Central Desert,115,5.547515678,155,7.549926936,270,6.543868153
7,Northern Territory,70700,Coomalie,207,26.91807542,149,22.85276074,356,25.05277973
7,Northern Territory,71000,Darwin,4967,11.48704903,4749,11.24689165,9716,11.36839642
7,Northern Territory,71150,Darwin Waterfront Precinct,18,12.08053691,15,11.27819549,33,11.70212766
7,Northern Territory,71300,East Arnhem,202,4.128346618,236,4.611176241,438,4.375187294
7,Northern Territory,72200,Katherine,558,10.00537924,434,8.26351866,992,9.160587312
7,Northern Territory,72300,Litchfield,1672,12.94819174,1356,12.91182632,3028,12.93188127
7,Northern Territory,72330,MacDonnell,122,3.502727534,206,6.391560658,328,4.891142261
7,Northern Territory,72800,Palmerston,1339,6.492750812,1395,6.808199122,2734,6.649964731
7,Northern Territory,73600,Roper Gulf,260,6.922257721,234,6.265060241,494,6.594580163
7,Northern Territory,74050,Tiwi Islands,69,5.231235785,81,5.672268908,150,5.460502366
7,Northern Territory,74550,Victoria Daly,104,6.268836649,145,8.863080685,249,7.556904401
7,Northern Territory,74560,Wagait,64,27.11864407,54,23.68421053,118,25.43103448
7,Northern Territory,74660,West Arnhem,133,3.594594595,149,4.019422714,282,3.807209397
7,Northern Territory,74680,West Daly,49,2.850494474,90,5.272407733,139,4.057209574
7,Northern Territory,79399,Unincorporated NT,380,9.483404043,250,6.745817593,630,8.168028005
8,Australian Capital Territory,89399,Unincorporated ACT,28785,12.49777484,35139,14.87396559,63924,13.70095549
9,Other Territories,99399,Unincorp. Other Territories,322,26.30718954,359,27.78637771,681,27.06677266